30 100
TTGCTCCCCCCGGGGGTACGCTTCTGCAAC|AGGGCTTCCATCGTACGGTCTGACTTCTTT
GGGCGGGTCCCGTAACGGCAGACGTACAAC|CATACGGCCTGCCCGTCGCTTATTGTTAGC
CTTTACCTGAGTCAAATCAGTTGTCCTGCT|GCGTGCTGTTTGGGAAACAATCCACTGATC
ATCCATCGTACGGTCTGACTTCTTTCCAGG|ACGCCATTTTATCACGTAAAACCCCGGCGT
GAGCAAATGGCACATGACGACGGTCCACAG|TGGGAAGACCTACAAGTCGCTTTATTCTAT
AAGATCACATACGGCCTGCCCGTCGCTTAT|TGGCACATGACGACGGTCCACAGGCATATG
TAGAAATGGCAGGAAACCGCAGGAGATCCT|TATAGGAGGATGGTGAATGCTACATTCCTT
TCTGCAACTTCGCCTTATAGAAATGGCAGG|ACTTCTTTCCAGGGTCTTATAGGAGGATGG
ATAAGCTTCCCATACCATGCTACTTCAAGT|TTACGCATGCAAGTAAACGTCCATCGTACG
TTCCAGGGTTTGGACCGTCCATCGTACGGT|TCTTTCCAGGGTCAAATAAGGGTTCCCAGA
ATCCATCGTACGGTCTGACTTCTTTCCAGG|AAGATGGCTTTCCATAGGATGTCCATCGTA
CTTCTTTCCAGGGCTTCCATCGTACGGTCT|AAACCCCGGCGTGCGATAGCTCGGGTCTGT
TTCGTCGCGAACGGATCACCCGCCTCATCG|CATACCATGCTACTTCAAGTTCTAATCCAT
CATCGTACGGTCTGACTTCTTTCCAGGGTT|CAGGGCGGAATCCATCGTACGGTCTGACTT
TCCATCGTACGGTCTGACTTCTTTCCAGGG|AAGGGTTCCCAGACTTTGCGAGGTAATGGT
CTTTCCAGGGTTGGCAGGTTGCTCCCCCCG|ACGGTCTGACTTCTTTCCAGGGCTTCCATC
TCCATCGTACGGTCTGACTTCTTTCCAGGG|TAGTGCTCCGACAAACATTGGATTAGCCCG
TTATTGTTAGCCCTACGGTCTGGGCGAAAT|TATGTCCATCGTACGGTCTGACTTCTTTCC
CACTTGGTCGTGCGAGGATGTATCAAATGT|GTCCCGTAACGGCAGACGTACAACGAATCA
CCAGGGGTGCCGTATTTTGGGAAGACCTAC|ACGGTCTGACTTCTTTCCAGGGGCACGTTG
GCGAGGATGTATCAAATGTACATATTCCTC|GCAGACGTACAACGAATCATATAGCGTACT
CAGGGTAGCTCAAGATCACATACGGCCTGC|GCCCGAGCAAATGGCACATGACGACGGTCC
TTCAAGTTCTAATCCATCGTACGGTCTGAC|TCGTACGGTCTGACTTCTTTCCAGGGTAGC
CACCCGCCTCATCGAAGCAAGGGCCCGCGC|AAGTTCTAATCCATCGTACGGTCTGACTTC
ACTTCTTTCCAGGGTCAAATAAGGGTTCCC|TAGAAATGGCAGGAAACCGCAGGAGATCCT
CGACGGTCCACAGGCATATGTCCATCGTAC|CGCTTTATTCTATCCATCGTACGGTCTGAC
TGTCCTGCTCTTGGGGACGCCATTTTATCA|CCACTGATCCTACAGCTCTGTTCGGTTCGT
CCGGGGGTACGCTTCTGCAACTTCGCCTTA|ATCGTACGGTCTGACTTCTTTCCAGGGTCT
TTCGGATCCCATTATCGGAGGGTCCATCGT|TGCTCCCCCCGGGGGTACGCTTCTGCAACT
GTCGCGAACGGATCACCCGCCTCATCGAAG|ACCATGCTACTTCAAGTTCTAATCCATCGT
CTGACTTCTTTCCAGGGTCTTATAGGAGGA|GTAATTCCTCCATCGTACGGTCTGACTTCT
TATTCCTCCAATAGAGGACACATTTCCCTA|AGCGTACTTCCCCTACTATGGCGTAGGCCT
CATCGAAGCAAGGGCCCGCGCCCTAGGCCC|TCCATCGTACGGTCTGACTTCTTTCCAGGG
CATGACGACGGTCCACAGGCATATGTCCAT|CAAGTCGCTTTATTCTATCCATCGTACGGT
CCATTCGGATCCCATTATCGGAGGGTCCAT|GGTTGCTCCCCCCGGGGGTACGCTTCTGCA
CGCAGGAGATCCTTCCATCGTACGGTCTGA|TGCTACATTCCTTTACCTGAGTCAAATCAG
TTAACATCGCCCCAGCCCGTCTCCATTCGG|TGACTTCTTTCCAGGGTTGGCAGGTTGCTC
AGAGGCTGAGGGGAATATCCATCGTACGGT|TGTCATAATTGTAGTGTTCCACCCCGAAGC
GCAACTCCATCGTACGGTCTGACTTCTTTC|ATATGCTGAGATTGAATCCACACGTGTGTT
TACGGTCTGGGCGAAATGGAATCGCAAGAG|CGGTCTGACTTCTTTCCAGGGAGTGCAGAG
GGTCTGACTTCTTTCCAGGGTTTGGACCGT|TACGGTCTGACTTCTTTCCAGGGTCAAATA
GGTCCACAGGCATATGTCCATCGTACGGTC|TTATTCTATCCATCGTACGGTCTGACTTCT
TTCTTTCCAGGGCGGAATCCATCGTACGGT|TGTCCTGCTCTTGGGGACGCCATTTTATCA
CTACGCTGTCATAATTGTAGTGTTCCACCC|CTTCTTTCCAGGGAGTACGCTCCGGCCCAG
TTCCAGGGCTTCCATCGTACGGTCTGACTT|CCGGCGTGCGATAGCTCGGGTCTGTAATTC
CCATTTTATCACGTAAAACCCCGGCGTGCG|GTTCGGTTCGTCGCGAACGGATCACCCGCC
CTTCTTTCCAGGGTTGGCAGGTTGCTCCCC|CGTACGGTCTGACTTCTTTCCAGGGCTTCC
TAGGAGGATGGTGAATGCTACATTCCTTTA|TGACTTCTTTCCAGGGGGTCCACGGGCGTG
CTGACTTCTTTCCAGGGCCAATCCCTACGC|TAGGATGTCCATCGTACGGTCTGACTTCTT
GGGTCCCGTAACGGCAGACGTACAACGAAT|CGGCCTGCCCGTCGCTTATTGTTAGCCCTA
CCATTATCGGAGGGTCCATCGTACGGTCTG|CCGGGGGTACGCTTCTGCAACTTCGCCTTA
TCCTACAGCTCTGTTCGGTTCGTCGCGAAC|ATTTCCCTATAAGCTTCCCATACCATGCTA
GAATCATATAGCGTACTTCCCCTACTATGG|CCTACGGTCTGGGCGAAATGGAATCGCAAG
CTGAGTCAAATCAGTTGTCCTGCTCTTGGG|TGTTTGGGAAACAATCCACTGATCCTACAG
TCCAGGGTCTTATAGGAGGATGGTGAATGC|CATCGTACGGTCTGACTTCTTTCCAGGGGG
GTCTGACTTCTTTCCAGGGTAGCTCAAGAT|CAAACATTGGATTAGCCCGAGCAAATGGCA
TCGCGAACGGATCACCCGCCTCATCGAAGC|CCATGCTACTTCAAGTTCTAATCCATCGTA
AGGGTCAAATAAGGGTTCCCAGACTTTGCG|AGGAAACCGCAGGAGATCCTTCCATCGTAC
CAATCCCATGCAAGTAGTGCTCCGACAAAC|TATCCATCGTACGGTCTGACTTCTTTCCAG
ACCCCGAAGCAACTCCATCGTACGGTCTGA|CCAGAGCTATATGCTGAGATTGAATCCACA
TCGTACGGTCTGACTTCTTTCCAGGGTTTG|CCATCGTACGGTCTGACTTCTTTCCAGGGT
GTACGCTTCTGCAACTTCGCCTTATAGAAA|CGGTCTGACTTCTTTCCAGGGTCTTATAGG
GTAACGGCAGACGTACAACGAATCATATAG|CCCGTCGCTTATTGTTAGCCCTACGGTCTG
AATCATATAGCGTACTTCCCCTACTATGGC|CTACGGTCTGGGCGAAATGGAATCGCAAGA
CGTAAAACCCCGGCGTGCGATAGCTCGGGT|CGCGAACGGATCACCCGCCTCATCGAAGCA
TGGTGGTTCCATCGTACGGTCTGACTTCTT|ACTTCTTTCCAGGGCGGAATCCATCGTACG
GCTCAAGATCACATACGGCCTGCCCGTCGC|CAAATGGCACATGACGACGGTCCACAGGCA
TCCAGGGCGGAATCCATCGTACGGTCTGAC|TGCTCTTGGGGACGCCATTTTATCACGTAA
ACGGTCTGACTTCTTTCCAGGGTTGGCAGG|GGAATCCATCGTACGGTCTGACTTCTTTCC
CATCGTACGGTCTGACTTCTTTCCAGGGCC|ATGGCTTTCCATAGGATGTCCATCGTACGG
CTCCATTCGGATCCCATTATCGGAGGGTCC|CAGGTTGCTCCCCCCGGGGGTACGCTTCTG
TTGGATTAGCCCGAGCAAATGGCACATGAC|GGTGCCGTATTTTGGGAAGACCTACAAGTC
CAAATGTACATATTCCTCCAATAGAGGACA|CGAATCATATAGCGTACTTCCCCTACTATG
ACGGTCTGACTTCTTTCCAGGGGTGCCGTA|GAAGCAACTCCATCGTACGGTCTGACTTCT
AAGAGTCCTTGATTAACAATCCCATGCAAG|CAGAGGCTGAGGGGAATATCCATCGTACGG
CTTTCCAGGGTAGCTCAAGATCACATACGG|GATTAGCCCGAGCAAATGGCACATGACGAC
GTATCAAATGTACATATTCCTCCAATAGAG|ACAACGAATCATATAGCGTACTTCCCCTAC
TCTTTCCAGGGCATGTACAGGCTGAATTTT|GAGGTAATGGTGGTTCCATCGTACGGTCTG
TCAAATAAGGGTTCCCAGACTTTGCGAGGT|AACCGCAGGAGATCCTTCCATCGTACGGTC
ATCGTACGGTCTGACTTCTTTCCAGGGGGT|TAGGCCCAATCACTTGGTCGTGCGAGGATG
TGGCGTAGGCCTTACGCATGCAAGTAAACG|AAGAGTCCTTGATTAACAATCCCATGCAAG
TCGAAGCAAGGGCCCGCGCCCTAGGCCCAA|CATCGTACGGTCTGACTTCTTTCCAGGGCG
CAGGGCATGTACAGGCTGAATTTTAACATC|ATGGTGGTTCCATCGTACGGTCTGACTTCT
CTCTGTTCGGTTCGTCGCGAACGGATCACC|ATAAGCTTCCCATACCATGCTACTTCAAGT
ACATCGCCCCAGCCCGTCTCCATTCGGATC|CTTCTTTCCAGGGTTGGCAGGTTGCTCCCC
CCAGGGCGGAATCCATCGTACGGTCTGACT|GCTCTTGGGGACGCCATTTTATCACGTAAA
CCAATAGAGGACACATTTCCCTATAAGCTT|TTCCCCTACTATGGCGTAGGCCTTACGCAT
CCATGCAAGTAGTGCTCCGACAAACATTGG|ATCGTACGGTCTGACTTCTTTCCAGGGGTG
TATTCTATCCATCGTACGGTCTGACTTCTT|TAATCGAAGATGGCTTTCCATAGGATGTCC
TATAGGAGGATGGTGAATGCTACATTCCTT|TCTGACTTCTTTCCAGGGGGTCCACGGGCG
ATTCCTCCAATAGAGGACACATTTCCCTAT|GCGTACTTCCCCTACTATGGCGTAGGCCTT
CTTTCCAGGGCCAATCCCTACGCTGTCATA|TCCATCGTACGGTCTGACTTCTTTCCAGGG
GGCGTGCTGTTTGGGAAACAATCCACTGAT|AATGTACATATTCCTCCAATAGAGGACACA
GGTCTGACTTCTTTCCAGGGCGGGTCCCGT|AGGGTAGCTCAAGATCACATACGGCCTGCC
ATCGTACGGTCTGACTTCTTTCCAGGGCGG|CTGAGTCAAATCAGTTGTCCTGCTCTTGGG
TTTCCAGGGAGTGCAGAGGCTGAGGGGAAT|GCCAATCCCTACGCTGTCATAATTGTAGTG
CCCAGCCCGTCTCCATTCGGATCCCATTAT|CCAGGGTTGGCAGGTTGCTCCCCCCGGGGG
CTCCATCGTACGGTCTGACTTCTTTCCAGG|GCTGAGATTGAATCCACACGTGTGTTGCCT
TAATTCCTCCATCGTACGGTCTGACTTCTT|GCCCGCGCCCTAGGCCCAATCACTTGGTCG
GCGAGGTAATGGTGGTTCCATCGTACGGTC|TACGGTCTGACTTCTTTCCAGGGCGGAATC
GGGTTCCCAGACTTTGCGAGGTAATGGTGG|GAGATCCTTCCATCGTACGGTCTGACTTCT
CAGGGCGGGTCCCGTAACGGCAGACGTACA|CACATACGGCCTGCCCGTCGCTTATTGTTA
GCTCTGTTCGGTTCGTCGCGAACGGATCAC|TATAAGCTTCCCATACCATGCTACTTCAAG
GCGGGTCCCGTAACGGCAGACGTACAACGA|TACGGCCTGCCCGTCGCTTATTGTTAGCCC
TCATAATTGTAGTGTTCCACCCCGAAGCAA|CAGGGAGTACGCTCCGGCCCAGAGCTATAT
TCCAGGGCTTCCATCGTACGGTCTGACTTC|CGGCGTGCGATAGCTCGGGTCTGTAATTCC
CTCCATCGTACGGTCTGACTTCTTTCCAGG|GCCCTAGGCCCAATCACTTGGTCGTGCGAG
TCGTACGGTCTGACTTCTTTCCAGGGCCAA|GGCTTTCCATAGGATGTCCATCGTACGGTC
ATAGGAGGATGGTGAATGCTACATTCCTTT|CTGACTTCTTTCCAGGGGGTCCACGGGCGT
CATATTCCTCCAATAGAGGACACATTTCCC|ATAGCGTACTTCCCCTACTATGGCGTAGGC
TCCAGGGCCAATCCCTACGCTGTCATAATT|ATCGTACGGTCTGACTTCTTTCCAGGGAGT
TCTTTCCAGGGCGGGTCCCGTAACGGCAGA|CAAGATCACATACGGCCTGCCCGTCGCTTA
ATGCAAGTAGTGCTCCGACAAACATTGGAT|CGTACGGTCTGACTTCTTTCCAGGGGTGCC
GCTTTATTCTATCCATCGTACGGTCTGACT|AACATAATCGAAGATGGCTTTCCATAGGAT
ACTTCTTTCCAGGGCATGTACAGGCTGAAT|TGCGAGGTAATGGTGGTTCCATCGTACGGT
TACGGTCTGACTTCTTTCCAGGGTAGCTCA|CCGACAAACATTGGATTAGCCCGAGCAAAT
GAAATGGCAGGAAACCGCAGGAGATCCTTC|TAGGAGGATGGTGAATGCTACATTCCTTTA
TACATTCCTTTACCTGAGTCAAATCAGTTG|TCCACGGGCGTGCTGTTTGGGAAACAATCC
ATGTACATATTCCTCCAATAGAGGACACAT|ATCATATAGCGTACTTCCCCTACTATGGCG
TGAATTTTAACATCGCCCCAGCCCGTCTCC|ACGGTCTGACTTCTTTCCAGGGTTGGCAGG
AGCAAATGGCACATGACGACGGTCCACAGG|GGGAAGACCTACAAGTCGCTTTATTCTATC
AAATGGCAGGAAACCGCAGGAGATCCTTCC|AGGAGGATGGTGAATGCTACATTCCTTTAC
GTACAGGCTGAATTTTAACATCGCCCCAGC|TCCATCGTACGGTCTGACTTCTTTCCAGGG
ACTTCTTTCCAGGGTAGCTCAAGATCACAT|ATTGGATTAGCCCGAGCAAATGGCACATGA
GTGCGATAGCTCGGGTCTGTAATTCCTCCA|CCGCCTCATCGAAGCAAGGGCCCGCGCCCT
CCGAAGCAACTCCATCGTACGGTCTGACTT|GAGCTATATGCTGAGATTGAATCCACACGT
TCACCCGCCTCATCGAAGCAAGGGCCCGCG|CAAGTTCTAATCCATCGTACGGTCTGACTT
TGACTTCTTTCCAGGGCTTCCATCGTACGG|GTAAAACCCCGGCGTGCGATAGCTCGGGTC
ACAGGCTGAATTTTAACATCGCCCCAGCCC|CATCGTACGGTCTGACTTCTTTCCAGGGTT
TAGGCCCAATCACTTGGTCGTGCGAGGATG|TCCAGGGCGGGTCCCGTAACGGCAGACGTA
ATCCTTCCATCGTACGGTCTGACTTCTTTC|TCCTTTACCTGAGTCAAATCAGTTGTCCTG
TGACTTCTTTCCAGGGAGTGCAGAGGCTGA|TTCCAGGGCCAATCCCTACGCTGTCATAAT
CTTATAGGAGGATGGTGAATGCTACATTCC|GGTCTGACTTCTTTCCAGGGGGTCCACGGG
GTCGCTTTATTCTATCCATCGTACGGTCTG|AGCAACATAATCGAAGATGGCTTTCCATAG
GTCTGGGCGAAATGGAATCGCAAGAGTCCT|CTGACTTCTTTCCAGGGAGTGCAGAGGCTG
TAGAGGACACATTTCCCTATAAGCTTCCCA|CCTACTATGGCGTAGGCCTTACGCATGCAA
TCCATCGTACGGTCTGACTTCTTTCCAGGG|ACTTCTTTCCAGGGTAGCTCAAGATCACAT
CGGCAGACGTACAACGAATCATATAGCGTA|TCGCTTATTGTTAGCCCTACGGTCTGGGCG
GTCCTGCTCTTGGGGACGCCATTTTATCAC|CACTGATCCTACAGCTCTGTTCGGTTCGTC
ACATTGGATTAGCCCGAGCAAATGGCACAT|AGGGGTGCCGTATTTTGGGAAGACCTACAA
CCCATTATCGGAGGGTCCATCGTACGGTCT|CCCGGGGGTACGCTTCTGCAACTTCGCCTT
CAAGAGTCCTTGATTAACAATCCCATGCAA|GCAGAGGCTGAGGGGAATATCCATCGTACG
GAGGACACATTTCCCTATAAGCTTCCCATA|TACTATGGCGTAGGCCTTACGCATGCAAGT
CTTCTTTCCAGGGAGTGCAGAGGCTGAGGG|CAGGGCCAATCCCTACGCTGTCATAATTGT
AACGTCCATCGTACGGTCTGACTTCTTTCC|CAAGTAGTGCTCCGACAAACATTGGATTAG
ACTTCTTTCCAGGGCGGGTCCCGTAACGGC|GCTCAAGATCACATACGGCCTGCCCGTCGC
GCATGCAAGTAAACGTCCATCGTACGGTCT|ACAATCCCATGCAAGTAGTGCTCCGACAAA
TTCCAGGGTCAAATAAGGGTTCCCAGACTT|TGGCAGGAAACCGCAGGAGATCCTTCCATC
GTAATGGTGGTTCCATCGTACGGTCTGACT|TCTGACTTCTTTCCAGGGCGGAATCCATCG
GCCCTAGGCCCAATCACTTGGTCGTGCGAG|TCTTTCCAGGGCGGGTCCCGTAACGGCAGA
CATCGTACGGTCTGACTTCTTTCCAGGGGT|CACCCCGAAGCAACTCCATCGTACGGTCTG
CCCCGAAGCAACTCCATCGTACGGTCTGAC|CAGAGCTATATGCTGAGATTGAATCCACAC
CTGGGCGAAATGGAATCGCAAGAGTCCTTG|GACTTCTTTCCAGGGAGTGCAGAGGCTGAG
GTAATTCCTCCATCGTACGGTCTGACTTCT|GGCCCGCGCCCTAGGCCCAATCACTTGGTC
ATCCCATTATCGGAGGGTCCATCGTACGGT|CCCCCGGGGGTACGCTTCTGCAACTTCGCC
CCTGAGTCAAATCAGTTGTCCTGCTCTTGG|CTGTTTGGGAAACAATCCACTGATCCTACA
GGTCTGACTTCTTTCCAGGGTAGCTCAAGA|ACAAACATTGGATTAGCCCGAGCAAATGGC
ATCGTACGGTCTGACTTCTTTCCAGGGCGG|TCTTTCCAGGGTAGCTCAAGATCACATACG
ATTTTGGGAAGACCTACAAGTCGCTTTATT|TTTCCAGGGGCACGTTGAGAGCAACATAAT
ACTTCTTTCCAGGGAGTGCAGAGGCTGAGG|CCAGGGCCAATCCCTACGCTGTCATAATTG
TTATCACGTAAAACCCCGGCGTGCGATAGC|GTTCGTCGCGAACGGATCACCCGCCTCATC
GACTTCTTTCCAGGGCATGTACAGGCTGAA|TTGCGAGGTAATGGTGGTTCCATCGTACGG
CGTATTTTGGGAAGACCTACAAGTCGCTTT|TTCTTTCCAGGGGCACGTTGAGAGCAACAT
GCAGGAAACCGCAGGAGATCCTTCCATCGT|GATGGTGAATGCTACATTCCTTTACCTGAG
GTCTGACTTCTTTCCAGGGTTTGGACCGTC|ACGGTCTGACTTCTTTCCAGGGTCAAATAA
CCCTACGCTGTCATAATTGTAGTGTTCCAC|GACTTCTTTCCAGGGAGTACGCTCCGGCCC
TCCAGGGTTGGCAGGTTGCTCCCCCCGGGG|GTCTGACTTCTTTCCAGGGCTTCCATCGTA
ACGGTCTGACTTCTTTCCAGGGTAGCTCAA|CGACAAACATTGGATTAGCCCGAGCAAATG
ACGGTCTGACTTCTTTCCAGGGGGTCCACG|CCAATCACTTGGTCGTGCGAGGATGTATCA
AGGTAATGGTGGTTCCATCGTACGGTCTGA|GGTCTGACTTCTTTCCAGGGCGGAATCCAT
CTGATCCTACAGCTCTGTTCGGTTCGTCGC|ACACATTTCCCTATAAGCTTCCCATACCAT
TCGGGTCTGTAATTCCTCCATCGTACGGTC|GAAGCAAGGGCCCGCGCCCTAGGCCCAATC
CACGGGCGTGCTGTTTGGGAAACAATCCAC|ATCAAATGTACATATTCCTCCAATAGAGGA
CCAGGGTAGCTCAAGATCACATACGGCCTG|AGCCCGAGCAAATGGCACATGACGACGGTC
TTGGGAAGACCTACAAGTCGCTTTATTCTA|CCAGGGGCACGTTGAGAGCAACATAATCGA
GAAGCAAGGGCCCGCGCCCTAGGCCCAATC|TCGTACGGTCTGACTTCTTTCCAGGGCGGG
GGGGACGCCATTTTATCACGTAAAACCCCG|CAGCTCTGTTCGGTTCGTCGCGAACGGATC
CGGGTCCCGTAACGGCAGACGTACAACGAA|ACGGCCTGCCCGTCGCTTATTGTTAGCCCT
CGGTCTGGGCGAAATGGAATCGCAAGAGTC|GTCTGACTTCTTTCCAGGGAGTGCAGAGGC
GAGTGCAGAGGCTGAGGGGAATATCCATCG|CTACGCTGTCATAATTGTAGTGTTCCACCC
GGCAGACGTACAACGAATCATATAGCGTAC|CGCTTATTGTTAGCCCTACGGTCTGGGCGA
CCCCTACTATGGCGTAGGCCTTACGCATGC|TGGAATCGCAAGAGTCCTTGATTAACAATC
TTCTTTCCAGGGTCAAATAAGGGTTCCCAG|GAAATGGCAGGAAACCGCAGGAGATCCTTC
ATCCTACAGCTCTGTTCGGTTCGTCGCGAA|CATTTCCCTATAAGCTTCCCATACCATGCT
GGAAACAATCCACTGATCCTACAGCTCTGT|CTCCAATAGAGGACACATTTCCCTATAAGC
GGATTAGCCCGAGCAAATGGCACATGACGA|TGCCGTATTTTGGGAAGACCTACAAGTCGC
CTTCTTTCCAGGGTCTTATAGGAGGATGGT|TTCCTCCATCGTACGGTCTGACTTCTTTCC
GGACCGTCCATCGTACGGTCTGACTTCTTT|TCAAATAAGGGTTCCCAGACTTTGCGAGGT
GAACGGATCACCCGCCTCATCGAAGCAAGG|GCTACTTCAAGTTCTAATCCATCGTACGGT
GCGAACGGATCACCCGCCTCATCGAAGCAA|ATGCTACTTCAAGTTCTAATCCATCGTACG
TCCCATGCAAGTAGTGCTCCGACAAACATT|CCATCGTACGGTCTGACTTCTTTCCAGGGG
TCCGACAAACATTGGATTAGCCCGAGCAAA|TTCTTTCCAGGGGTGCCGTATTTTGGGAAG
TGCGAGGTAATGGTGGTTCCATCGTACGGT|GTACGGTCTGACTTCTTTCCAGGGCGGAAT
CCACGGGCGTGCTGTTTGGGAAACAATCCA|TATCAAATGTACATATTCCTCCAATAGAGG
TCCACAGGCATATGTCCATCGTACGGTCTG|ATTCTATCCATCGTACGGTCTGACTTCTTT
GCCCCAGCCCGTCTCCATTCGGATCCCATT|TTCCAGGGTTGGCAGGTTGCTCCCCCCGGG
GTACGGTCTGACTTCTTTCCAGGGTAGCTC|TCCGACAAACATTGGATTAGCCCGAGCAAA
GGCCTGCCCGTCGCTTATTGTTAGCCCTAC|ACGGTCCACAGGCATATGTCCATCGTACGG
GGATCCCATTATCGGAGGGTCCATCGTACG|TCCCCCCGGGGGTACGCTTCTGCAACTTCG
TCCATCGTACGGTCTGACTTCTTTCCAGGG|TCCACCCCGAAGCAACTCCATCGTACGGTC
GTACGGTCTGACTTCTTTCCAGGGCCAATC|CTTTCCATAGGATGTCCATCGTACGGTCTG
GGTCTGACTTCTTTCCAGGGCATGTACAGG|AGACTTTGCGAGGTAATGGTGGTTCCATCG
GGGAATATCCATCGTACGGTCTGACTTCTT|GTAGTGTTCCACCCCGAAGCAACTCCATCG
TTGGGAAACAATCCACTGATCCTACAGCTC|TTCCTCCAATAGAGGACACATTTCCCTATA
TTATCGGAGGGTCCATCGTACGGTCTGACT|GGGGTACGCTTCTGCAACTTCGCCTTATAG
CTGACTTCTTTCCAGGGTTTGGACCGTCCA|GGTCTGACTTCTTTCCAGGGTCAAATAAGG
CAGACGTACAACGAATCATATAGCGTACTT|CTTATTGTTAGCCCTACGGTCTGGGCGAAA
CCGACAAACATTGGATTAGCCCGAGCAAAT|TCTTTCCAGGGGTGCCGTATTTTGGGAAGA
TGATCATGATCCATCGTACGGTCTGACTTC|ATTATCGGAGGGTCCATCGTACGGTCTGAC
TTGGTCGTGCGAGGATGTATCAAATGTACA|CCGTAACGGCAGACGTACAACGAATCATAT
CGTAACGGCAGACGTACAACGAATCATATA|GCCCGTCGCTTATTGTTAGCCCTACGGTCT
GCCCGCGCCCTAGGCCCAATCACTTGGTCG|CTGACTTCTTTCCAGGGCGGGTCCCGTAAC
GCCCTACGGTCTGGGCGAAATGGAATCGCA|CGTACGGTCTGACTTCTTTCCAGGGAGTGC
CACATACGGCCTGCCCGTCGCTTATTGTTA|CATGACGACGGTCCACAGGCATATGTCCAT
GCGCCCTAGGCCCAATCACTTGGTCGTGCG|CTTCTTTCCAGGGCGGGTCCCGTAACGGCA
CAAGTTCTAATCCATCGTACGGTCTGACTT|GTACGGTCTGACTTCTTTCCAGGGTAGCTC
CTTCCCCTACTATGGCGTAGGCCTTACGCA|AAATGGAATCGCAAGAGTCCTTGATTAACA
GGGGTGCCGTATTTTGGGAAGACCTACAAG|GTCTGACTTCTTTCCAGGGGCACGTTGAGA
CCCGGGGGTACGCTTCTGCAACTTCGCCTT|CATCGTACGGTCTGACTTCTTTCCAGGGTC
ATCATATAGCGTACTTCCCCTACTATGGCG|TACGGTCTGGGCGAAATGGAATCGCAAGAG
GTCTGACTTCTTTCCAGGGTTGGCAGGTTG|ATCCATCGTACGGTCTGACTTCTTTCCAGG
CTGACTTCTTTCCAGGGTCAAATAAGGGTT|TTATAGAAATGGCAGGAAACCGCAGGAGAT
CTTCCCATACCATGCTACTTCAAGTTCTAA|CATGCAAGTAAACGTCCATCGTACGGTCTG
GTAGCTCAAGATCACATACGGCCTGCCCGT|GAGCAAATGGCACATGACGACGGTCCACAG
TTTTATCACGTAAAACCCCGGCGTGCGATA|CGGTTCGTCGCGAACGGATCACCCGCCTCA
CCATCGTACGGTCTGACTTCTTTCCAGGGC|AGGGTTCCCAGACTTTGCGAGGTAATGGTG
CGTCGCGAACGGATCACCCGCCTCATCGAA|TACCATGCTACTTCAAGTTCTAATCCATCG
CATAATTGTAGTGTTCCACCCCGAAGCAAC|AGGGAGTACGCTCCGGCCCAGAGCTATATG
TGTACAGGCTGAATTTTAACATCGCCCCAG|TTCCATCGTACGGTCTGACTTCTTTCCAGG
TGTACATATTCCTCCAATAGAGGACACATT|TCATATAGCGTACTTCCCCTACTATGGCGT
TACGGTCTGACTTCTTTCCAGGGCCAATCC|TTTCCATAGGATGTCCATCGTACGGTCTGA
GACTTCTTTCCAGGGGGTCCACGGGCGTGC|CTTGGTCGTGCGAGGATGTATCAAATGTAC
GGGTCTTATAGGAGGATGGTGAATGCTACA|GTACGGTCTGACTTCTTTCCAGGGGGTCCA
CCTACAAGTCGCTTTATTCTATCCATCGTA|CGTTGAGAGCAACATAATCGAAGATGGCTT
GTCTGACTTCTTTCCAGGGTCTTATAGGAG|CTGTAATTCCTCCATCGTACGGTCTGACTT
GTAGTGCTCCGACAAACATTGGATTAGCCC|GTCTGACTTCTTTCCAGGGGTGCCGTATTT
CTGTAATTCCTCCATCGTACGGTCTGACTT|AGGGCCCGCGCCCTAGGCCCAATCACTTGG
TCTGACTTCTTTCCAGGGCTTCCATCGTAC|ACGTAAAACCCCGGCGTGCGATAGCTCGGG
ATCCCTACGCTGTCATAATTGTAGTGTTCC|CTGACTTCTTTCCAGGGAGTACGCTCCGGC
CACATGACGACGGTCCACAGGCATATGTCC|TACAAGTCGCTTTATTCTATCCATCGTACG
CAATCCACTGATCCTACAGCTCTGTTCGGT|ATAGAGGACACATTTCCCTATAAGCTTCCC
ATTTTATCACGTAAAACCCCGGCGTGCGAT|TCGGTTCGTCGCGAACGGATCACCCGCCTC
TCGTCGCGAACGGATCACCCGCCTCATCGA|ATACCATGCTACTTCAAGTTCTAATCCATC
AACCGCAGGAGATCCTTCCATCGTACGGTC|GAATGCTACATTCCTTTACCTGAGTCAAAT
TAATCCATCGTACGGTCTGACTTCTTTCCA|CTGACTTCTTTCCAGGGTAGCTCAAGATCA
CGGTCTGACTTCTTTCCAGGGGGTCCACGG|CAATCACTTGGTCGTGCGAGGATGTATCAA
CGTACTTCCCCTACTATGGCGTAGGCCTTA|GGCGAAATGGAATCGCAAGAGTCCTTGATT
GGAAGACCTACAAGTCGCTTTATTCTATCC|GGGGCACGTTGAGAGCAACATAATCGAAGA
GCTCTTGGGGACGCCATTTTATCACGTAAA|ATCCTACAGCTCTGTTCGGTTCGTCGCGAA
AAACGTCCATCGTACGGTCTGACTTCTTTC|GCAAGTAGTGCTCCGACAAACATTGGATTA
ATCATGATCCATCGTACGGTCTGACTTCTT|TATCGGAGGGTCCATCGTACGGTCTGACTT
GATTAACAATCCCATGCAAGTAGTGCTCCG|GGGGAATATCCATCGTACGGTCTGACTTCT
TCCTGCTCTTGGGGACGCCATTTTATCACG|ACTGATCCTACAGCTCTGTTCGGTTCGTCG
GGGCGAAATGGAATCGCAAGAGTCCTTGAT|CTTCTTTCCAGGGAGTGCAGAGGCTGAGGG
ATATGTCCATCGTACGGTCTGACTTCTTTC|ATCGTACGGTCTGACTTCTTTCCAGGGCCA
ATGCTACATTCCTTTACCTGAGTCAAATCA|GGGGTCCACGGGCGTGCTGTTTGGGAAACA
TGTAATTCCTCCATCGTACGGTCTGACTTC|GGGCCCGCGCCCTAGGCCCAATCACTTGGT
AGAGGACACATTTCCCTATAAGCTTCCCAT|CTACTATGGCGTAGGCCTTACGCATGCAAG
GTCTCCATTCGGATCCCATTATCGGAGGGT|GGCAGGTTGCTCCCCCCGGGGGTACGCTTC
CGCTTTATTCTATCCATCGTACGGTCTGAC|CAACATAATCGAAGATGGCTTTCCATAGGA
CGTAGGCCTTACGCATGCAAGTAAACGTCC|AGTCCTTGATTAACAATCCCATGCAAGTAG
TCGTGCGAGGATGTATCAAATGTACATATT|AACGGCAGACGTACAACGAATCATATAGCG
TATTTTGGGAAGACCTACAAGTCGCTTTAT|CTTTCCAGGGGCACGTTGAGAGCAACATAA
TCGTACGGTCTGACTTCTTTCCAGGGTCAA|AACTTCGCCTTATAGAAATGGCAGGAAACC
AGATCACATACGGCCTGCCCGTCGCTTATT|GGCACATGACGACGGTCCACAGGCATATGT
GAAATGGAATCGCAAGAGTCCTTGATTAAC|TTTCCAGGGAGTGCAGAGGCTGAGGGGAAT
TTCCTTTACCTGAGTCAAATCAGTTGTCCT|CGGGCGTGCTGTTTGGGAAACAATCCACTG
CCACCCCGAAGCAACTCCATCGTACGGTCT|GCCCAGAGCTATATGCTGAGATTGAATCCA
GTTGTCCTGCTCTTGGGGACGCCATTTTAT|ATCCACTGATCCTACAGCTCTGTTCGGTTC
CTTTCCAGGGTTTGGACCGTCCATCGTACG|CTTCTTTCCAGGGTCAAATAAGGGTTCCCA
CTTGATTAACAATCCCATGCAAGTAGTGCT|TGAGGGGAATATCCATCGTACGGTCTGACT
GCAGGAGATCCTTCCATCGTACGGTCTGAC|GCTACATTCCTTTACCTGAGTCAAATCAGT
AAATGGCACATGACGACGGTCCACAGGCAT|AAGACCTACAAGTCGCTTTATTCTATCCAT
CAGGAAACCGCAGGAGATCCTTCCATCGTA|ATGGTGAATGCTACATTCCTTTACCTGAGT
CCTTTACCTGAGTCAAATCAGTTGTCCTGC|GGCGTGCTGTTTGGGAAACAATCCACTGAT
TGGAATCGCAAGAGTCCTTGATTAACAATC|CAGGGAGTGCAGAGGCTGAGGGGAATATCC
ATGGCGTAGGCCTTACGCATGCAAGTAAAC|CAAGAGTCCTTGATTAACAATCCCATGCAA
GCCGTATTTTGGGAAGACCTACAAGTCGCT|ACTTCTTTCCAGGGGCACGTTGAGAGCAAC
GTACGGTCTGACTTCTTTCCAGGGAGTGCA|TGACTTCTTTCCAGGGCCAATCCCTACGCT
GGTCCACGGGCGTGCTGTTTGGGAAACAAT|ATGTATCAAATGTACATATTCCTCCAATAG
GGACGCCATTTTATCACGTAAAACCCCGGC|GCTCTGTTCGGTTCGTCGCGAACGGATCAC
TTCTATCCATCGTACGGTCTGACTTCTTTC|ATCGAAGATGGCTTTCCATAGGATGTCCAT
TCGTACGGTCTGACTTCTTTCCAGGGTTGG|GGGCGGAATCCATCGTACGGTCTGACTTCT
TACGCTTCTGCAACTTCGCCTTATAGAAAT|GGTCTGACTTCTTTCCAGGGTCTTATAGGA
TGCGAGGATGTATCAAATGTACATATTCCT|GGCAGACGTACAACGAATCATATAGCGTAC
CGGTCTGACTTCTTTCCAGGGCGGAATCCA|CAAATCAGTTGTCCTGCTCTTGGGGACGCC
GTCCTTGATTAACAATCCCATGCAAGTAGT|GGCTGAGGGGAATATCCATCGTACGGTCTG
CCATCGTACGGTCTGACTTCTTTCCAGGGC|CTTCTTTCCAGGGTAGCTCAAGATCACATA
ACAAGTCGCTTTATTCTATCCATCGTACGG|TGAGAGCAACATAATCGAAGATGGCTTTCC
CTTCCATCGTACGGTCTGACTTCTTTCCAG|CGATAGCTCGGGTCTGTAATTCCTCCATCG
GGGTAGCTCAAGATCACATACGGCCTGCCC|CCGAGCAAATGGCACATGACGACGGTCCAC
TCCAGGGTAGCTCAAGATCACATACGGCCT|TAGCCCGAGCAAATGGCACATGACGACGGT
CCAGGGCGGGTCCCGTAACGGCAGACGTAC|TCACATACGGCCTGCCCGTCGCTTATTGTT
TTGATTAACAATCCCATGCAAGTAGTGCTC|GAGGGGAATATCCATCGTACGGTCTGACTT
CAGGGTTTGGACCGTCCATCGTACGGTCTG|TTCCAGGGTCAAATAAGGGTTCCCAGACTT
CAGGGGGTCCACGGGCGTGCTGTTTGGGAA|CGAGGATGTATCAAATGTACATATTCCTCC
CGTGCTGTTTGGGAAACAATCCACTGATCC|TGTACATATTCCTCCAATAGAGGACACATT
GATCATGATCCATCGTACGGTCTGACTTCT|TTATCGGAGGGTCCATCGTACGGTCTGACT
CAAGGGCCCGCGCCCTAGGCCCAATCACTT|ACGGTCTGACTTCTTTCCAGGGCGGGTCCC
GTTGCTCCCCCCGGGGGTACGCTTCTGCAA|CAGGGCTTCCATCGTACGGTCTGACTTCTT
CTGAATTTTAACATCGCCCCAGCCCGTCTC|TACGGTCTGACTTCTTTCCAGGGTTGGCAG
ACTTCTTTCCAGGGTTGGCAGGTTGCTCCC|TCGTACGGTCTGACTTCTTTCCAGGGCTTC
CGGATCCCATTATCGGAGGGTCCATCGTAC|CTCCCCCCGGGGGTACGCTTCTGCAACTTC
CAGGTTGCTCCCCCCGGGGGTACGCTTCTG|TTCCAGGGCTTCCATCGTACGGTCTGACTT
ACGCCATTTTATCACGTAAAACCCCGGCGT|TCTGTTCGGTTCGTCGCGAACGGATCACCC
TATTGTTAGCCCTACGGTCTGGGCGAAATG|ATGTCCATCGTACGGTCTGACTTCTTTCCA
AGTCCTTGATTAACAATCCCATGCAAGTAG|AGGCTGAGGGGAATATCCATCGTACGGTCT
AATAAGGGTTCCCAGACTTTGCGAGGTAAT|CGCAGGAGATCCTTCCATCGTACGGTCTGA
ACTTCTTTCCAGGGGGTCCACGGGCGTGCT|TTGGTCGTGCGAGGATGTATCAAATGTACA
GTCCACGGGCGTGCTGTTTGGGAAACAATC|TGTATCAAATGTACATATTCCTCCAATAGA
GGCGGAATCCATCGTACGGTCTGACTTCTT|TTGGGGACGCCATTTTATCACGTAAAACCC
TTCGCCTTATAGAAATGGCAGGAAACCGCA|CCAGGGTCTTATAGGAGGATGGTGAATGCT
GTATTTTGGGAAGACCTACAAGTCGCTTTA|TCTTTCCAGGGGCACGTTGAGAGCAACATA
CTTCTTTCCAGGGCGGGTCCCGTAACGGCA|CTCAAGATCACATACGGCCTGCCCGTCGCT
CTTCTTTCCAGGGTCAAATAAGGGTTCCCA|AGAAATGGCAGGAAACCGCAGGAGATCCTT
TTATAGAAATGGCAGGAAACCGCAGGAGAT|TCTTATAGGAGGATGGTGAATGCTACATTC
GGCAGGTTGCTCCCCCCGGGGGTACGCTTC|CTTTCCAGGGCTTCCATCGTACGGTCTGAC
TGCTCCCCCCGGGGGTACGCTTCTGCAACT|GGGCTTCCATCGTACGGTCTGACTTCTTTC
CCGTAACGGCAGACGTACAACGAATCATAT|TGCCCGTCGCTTATTGTTAGCCCTACGGTC
TAGTGTTCCACCCCGAAGCAACTCCATCGT|CGCTCCGGCCCAGAGCTATATGCTGAGATT
ACAATCCACTGATCCTACAGCTCTGTTCGG|AATAGAGGACACATTTCCCTATAAGCTTCC
CTTCTTTCCAGGGTTTGGACCGTCCATCGT|TGACTTCTTTCCAGGGTCAAATAAGGGTTC
CAGACTTTGCGAGGTAATGGTGGTTCCATC|TTCCATCGTACGGTCTGACTTCTTTCCAGG
TGAGGGGAATATCCATCGTACGGTCTGACT|AATTGTAGTGTTCCACCCCGAAGCAACTCC
GTACGGTCTGACTTCTTTCCAGGGCGGGTC|TTCCAGGGTAGCTCAAGATCACATACGGCC
ACCTGAGTCAAATCAGTTGTCCTGCTCTTG|GCTGTTTGGGAAACAATCCACTGATCCTAC
AATCCCTACGCTGTCATAATTGTAGTGTTC|TCTGACTTCTTTCCAGGGAGTACGCTCCGG
CGAAATGGAATCGCAAGAGTCCTTGATTAA|CTTTCCAGGGAGTGCAGAGGCTGAGGGGAA
TACCTGAGTCAAATCAGTTGTCCTGCTCTT|TGCTGTTTGGGAAACAATCCACTGATCCTA
GACGACGGTCCACAGGCATATGTCCATCGT|GTCGCTTTATTCTATCCATCGTACGGTCTG
CGTACGGTCTGACTTCTTTCCAGGGTCAAA|ACTTCGCCTTATAGAAATGGCAGGAAACCG
TGATCCATCGTACGGTCTGACTTCTTTCCA|GGAGGGTCCATCGTACGGTCTGACTTCTTT
TCTTTCCAGGGTCAAATAAGGGTTCCCAGA|AAATGGCAGGAAACCGCAGGAGATCCTTCC
GGGCATGTACAGGCTGAATTTTAACATCGC|GGTGGTTCCATCGTACGGTCTGACTTCTTT
GGTCTGTAATTCCTCCATCGTACGGTCTGA|GCAAGGGCCCGCGCCCTAGGCCCAATCACT
GGCAGGAAACCGCAGGAGATCCTTCCATCG|GGATGGTGAATGCTACATTCCTTTACCTGA
ACGCTTCTGCAACTTCGCCTTATAGAAATG|GTCTGACTTCTTTCCAGGGTCTTATAGGAG
CGATAGCTCGGGTCTGTAATTCCTCCATCG|CCTCATCGAAGCAAGGGCCCGCGCCCTAGG
GGGGAATATCCATCGTACGGTCTGACTTCT|TGTAGTGTTCCACCCCGAAGCAACTCCATC
CATCGTACGGTCTGACTTCTTTCCAGGGTT|GTCCATCGTACGGTCTGACTTCTTTCCAGG
CCCATACCATGCTACTTCAAGTTCTAATCC|GCAAGTAAACGTCCATCGTACGGTCTGACT
CGTACGGTCTGACTTCTTTCCAGGGTAGCT|CTCCGACAAACATTGGATTAGCCCGAGCAA
TTCTTTCCAGGGAGTGCAGAGGCTGAGGGG|AGGGCCAATCCCTACGCTGTCATAATTGTA
ACGGTCCACAGGCATATGTCCATCGTACGG|CTTTATTCTATCCATCGTACGGTCTGACTT
GCCTCATCGAAGCAAGGGCCCGCGCCCTAG|CTAATCCATCGTACGGTCTGACTTCTTTCC
CCTGCTCTTGGGGACGCCATTTTATCACGT|CTGATCCTACAGCTCTGTTCGGTTCGTCGC
TCTGTAATTCCTCCATCGTACGGTCTGACT|AAGGGCCCGCGCCCTAGGCCCAATCACTTG
TCACTTGGTCGTGCGAGGATGTATCAAATG|GGTCCCGTAACGGCAGACGTACAACGAATC
GAATCGCAAGAGTCCTTGATTAACAATCCC|GGGAGTGCAGAGGCTGAGGGGAATATCCAT
GGCATGTACAGGCTGAATTTTAACATCGCC|GTGGTTCCATCGTACGGTCTGACTTCTTTC
TCCCCCCGGGGGTACGCTTCTGCAACTTCG|CTTCCATCGTACGGTCTGACTTCTTTCCAG
TAACATCGCCCCAGCCCGTCTCCATTCGGA|GACTTCTTTCCAGGGTTGGCAGGTTGCTCC
GTAGTGTTCCACCCCGAAGCAACTCCATCG|ACGCTCCGGCCCAGAGCTATATGCTGAGAT
ATCGTACGGTCTGACTTCTTTCCAGGGCCA|TGGCTTTCCATAGGATGTCCATCGTACGGT
ATCGTACGGTCTGACTTCTTTCCAGGGTTT|TCCATCGTACGGTCTGACTTCTTTCCAGGG
GGGCCCGCGCCCTAGGCCCAATCACTTGGT|GTCTGACTTCTTTCCAGGGCGGGTCCCGTA
CATCGTACGGTCTGACTTCTTTCCAGGGCG|TTCTTTCCAGGGTAGCTCAAGATCACATAC
CTTCTTTCCAGGGTAGCTCAAGATCACATA|TTGGATTAGCCCGAGCAAATGGCACATGAC
CTACGGTCTGGGCGAAATGGAATCGCAAGA|ACGGTCTGACTTCTTTCCAGGGAGTGCAGA
TGATTAACAATCCCATGCAAGTAGTGCTCC|AGGGGAATATCCATCGTACGGTCTGACTTC
GCCTTACGCATGCAAGTAAACGTCCATCGT|TTGATTAACAATCCCATGCAAGTAGTGCTC
TTCTTTCCAGGGGGTCCACGGGCGTGCTGT|GGTCGTGCGAGGATGTATCAAATGTACATA
GATCACATACGGCCTGCCCGTCGCTTATTG|GCACATGACGACGGTCCACAGGCATATGTC
GTTCGTCGCGAACGGATCACCCGCCTCATC|CCATACCATGCTACTTCAAGTTCTAATCCA
CGTCCATCGTACGGTCTGACTTCTTTCCAG|AGTAGTGCTCCGACAAACATTGGATTAGCC
GCCTGCCCGTCGCTTATTGTTAGCCCTACG|CGGTCCACAGGCATATGTCCATCGTACGGT
TCTGACTTCTTTCCAGGGTTTGGACCGTCC|CGGTCTGACTTCTTTCCAGGGTCAAATAAG
ATTAACAATCCCATGCAAGTAGTGCTCCGA|GGGAATATCCATCGTACGGTCTGACTTCTT
GAGGCTGAGGGGAATATCCATCGTACGGTC|GTCATAATTGTAGTGTTCCACCCCGAAGCA
ATTAGCCCGAGCAAATGGCACATGACGACG|CCGTATTTTGGGAAGACCTACAAGTCGCTT
TATGGCGTAGGCCTTACGCATGCAAGTAAA|GCAAGAGTCCTTGATTAACAATCCCATGCA
CCCGTCGCTTATTGTTAGCCCTACGGTCTG|CACAGGCATATGTCCATCGTACGGTCTGAC
GTCTGTAATTCCTCCATCGTACGGTCTGAC|CAAGGGCCCGCGCCCTAGGCCCAATCACTT
AGGGGTGCCGTATTTTGGGAAGACCTACAA|GGTCTGACTTCTTTCCAGGGGCACGTTGAG
ACATATTCCTCCAATAGAGGACACATTTCC|TATAGCGTACTTCCCCTACTATGGCGTAGG
TACGGTCTGACTTCTTTCCAGGGTTGGCAG|CGGAATCCATCGTACGGTCTGACTTCTTTC
CTTCTGCAACTTCGCCTTATAGAAATGGCA|TGACTTCTTTCCAGGGTCTTATAGGAGGAT
ACTTCAAGTTCTAATCCATCGTACGGTCTG|CATCGTACGGTCTGACTTCTTTCCAGGGTA
CGTCGTGATCATGATCCATCGTACGGTCTG|ATCCCATTATCGGAGGGTCCATCGTACGGT
AATGCTACATTCCTTTACCTGAGTCAAATC|GGGGGTCCACGGGCGTGCTGTTTGGGAAAC
GGTGCCGTATTTTGGGAAGACCTACAAGTC|CTGACTTCTTTCCAGGGGCACGTTGAGAGC
ATACGGCCTGCCCGTCGCTTATTGTTAGCC|GACGACGGTCCACAGGCATATGTCCATCGT
AGGACACATTTCCCTATAAGCTTCCCATAC|ACTATGGCGTAGGCCTTACGCATGCAAGTA
ACGGTCTGACTTCTTTCCAGGGTCAAATAA|TCGCCTTATAGAAATGGCAGGAAACCGCAG
TAAACGTCCATCGTACGGTCTGACTTCTTT|TGCAAGTAGTGCTCCGACAAACATTGGATT
AGACTTTGCGAGGTAATGGTGGTTCCATCG|TCCATCGTACGGTCTGACTTCTTTCCAGGG
CGGTCTGACTTCTTTCCAGGGGTGCCGTAT|AAGCAACTCCATCGTACGGTCTGACTTCTT
CAAGTCGCTTTATTCTATCCATCGTACGGT|GAGAGCAACATAATCGAAGATGGCTTTCCA
CAGGGCGGAATCCATCGTACGGTCTGACTT|CTCTTGGGGACGCCATTTTATCACGTAAAA
CCAGGGGGTCCACGGGCGTGCTGTTTGGGA|GCGAGGATGTATCAAATGTACATATTCCTC
CTTTCCAGGGGTGCCGTATTTTGGGAAGAC|TCGTACGGTCTGACTTCTTTCCAGGGGCAC
CGGTCTGACTTCTTTCCAGGGTTGGCAGGT|GAATCCATCGTACGGTCTGACTTCTTTCCA
CGCCTTATAGAAATGGCAGGAAACCGCAGG|AGGGTCTTATAGGAGGATGGTGAATGCTAC
CAAGTAAACGTCCATCGTACGGTCTGACTT|CCCATGCAAGTAGTGCTCCGACAAACATTG
TACAGGCTGAATTTTAACATCGCCCCAGCC|CCATCGTACGGTCTGACTTCTTTCCAGGGT
GGGCTTCCATCGTACGGTCTGACTTCTTTC|GTGCGATAGCTCGGGTCTGTAATTCCTCCA
AGGGCCAATCCCTACGCTGTCATAATTGTA|GTACGGTCTGACTTCTTTCCAGGGAGTACG
GAGTCCTTGATTAACAATCCCATGCAAGTA|GAGGCTGAGGGGAATATCCATCGTACGGTC
GTAGGCCTTACGCATGCAAGTAAACGTCCA|GTCCTTGATTAACAATCCCATGCAAGTAGT
TCTCCATTCGGATCCCATTATCGGAGGGTC|GCAGGTTGCTCCCCCCGGGGGTACGCTTCT
TTCTTTCCAGGGTTTGGACCGTCCATCGTA|GACTTCTTTCCAGGGTCAAATAAGGGTTCC
CCATCGTACGGTCTGACTTCTTTCCAGGGT|TGCAACTTCGCCTTATAGAAATGGCAGGAA
TCCAGGGAGTGCAGAGGCTGAGGGGAATAT|CAATCCCTACGCTGTCATAATTGTAGTGTT
ATTTCCCTATAAGCTTCCCATACCATGCTA|CGTAGGCCTTACGCATGCAAGTAAACGTCC
TCTTTCCAGGGCGGAATCCATCGTACGGTC|GTCCTGCTCTTGGGGACGCCATTTTATCAC
CATCGTACGGTCTGACTTCTTTCCAGGGCG|CCTGAGTCAAATCAGTTGTCCTGCTCTTGG
TGGCAGGAAACCGCAGGAGATCCTTCCATC|AGGATGGTGAATGCTACATTCCTTTACCTG
CCAGGGTTTGGACCGTCCATCGTACGGTCT|TTTCCAGGGTCAAATAAGGGTTCCCAGACT
GGCCTTACGCATGCAAGTAAACGTCCATCG|CTTGATTAACAATCCCATGCAAGTAGTGCT
TCGCCCCAGCCCGTCTCCATTCGGATCCCA|CTTTCCAGGGTTGGCAGGTTGCTCCCCCCG
AGCCCGTCTCCATTCGGATCCCATTATCGG|GGGTTGGCAGGTTGCTCCCCCCGGGGGTAC
ATCACCCGCCTCATCGAAGCAAGGGCCCGC|TCAAGTTCTAATCCATCGTACGGTCTGACT
GGGAAACAATCCACTGATCCTACAGCTCTG|CCTCCAATAGAGGACACATTTCCCTATAAG
GACAAACATTGGATTAGCCCGAGCAAATGG|TTTCCAGGGGTGCCGTATTTTGGGAAGACC
CTTCTTTCCAGGGCCAATCCCTACGCTGTC|ATGTCCATCGTACGGTCTGACTTCTTTCCA
GGTCTGACTTCTTTCCAGGGCTTCCATCGT|TCACGTAAAACCCCGGCGTGCGATAGCTCG
AGTAAACGTCCATCGTACGGTCTGACTTCT|CATGCAAGTAGTGCTCCGACAAACATTGGA
CTACTTCAAGTTCTAATCCATCGTACGGTC|TCCATCGTACGGTCTGACTTCTTTCCAGGG
GTCTGACTTCTTTCCAGGGCATGTACAGGC|GACTTTGCGAGGTAATGGTGGTTCCATCGT
TCCATCGTACGGTCTGACTTCTTTCCAGGG|CCCTAGGCCCAATCACTTGGTCGTGCGAGG
GCGTGCTGTTTGGGAAACAATCCACTGATC|ATGTACATATTCCTCCAATAGAGGACACAT
GAAGCAACTCCATCGTACGGTCTGACTTCT|GCTATATGCTGAGATTGAATCCACACGTGT
TCCAGGGTCAAATAAGGGTTCCCAGACTTT|GGCAGGAAACCGCAGGAGATCCTTCCATCG
CTATAAGCTTCCCATACCATGCTACTTCAA|CCTTACGCATGCAAGTAAACGTCCATCGTA
TTTCCAGGGTTTGGACCGTCCATCGTACGG|TTCTTTCCAGGGTCAAATAAGGGTTCCCAG
TATAGAAATGGCAGGAAACCGCAGGAGATC|CTTATAGGAGGATGGTGAATGCTACATTCC
GATCCTACAGCTCTGTTCGGTTCGTCGCGA|ACATTTCCCTATAAGCTTCCCATACCATGC
TTGTTAGCCCTACGGTCTGGGCGAAATGGA|GTCCATCGTACGGTCTGACTTCTTTCCAGG
CCTACAGCTCTGTTCGGTTCGTCGCGAACG|TTTCCCTATAAGCTTCCCATACCATGCTAC
CGTACGGTCTGACTTCTTTCCAGGGCATGT|TTCCCAGACTTTGCGAGGTAATGGTGGTTC
CGGTCTGACTTCTTTCCAGGGCATGTACAG|CAGACTTTGCGAGGTAATGGTGGTTCCATC
TCCACGGGCGTGCTGTTTGGGAAACAATCC|GTATCAAATGTACATATTCCTCCAATAGAG
CGGTCTGACTTCTTTCCAGGGCCAATCCCT|TCCATAGGATGTCCATCGTACGGTCTGACT
GGTCTGACTTCTTTCCAGGGCGGAATCCAT|AAATCAGTTGTCCTGCTCTTGGGGACGCCA
TACGGTCTGACTTCTTTCCAGGGCTTCCAT|TTATCACGTAAAACCCCGGCGTGCGATAGC
CCCAATCACTTGGTCGTGCGAGGATGTATC|GGGCGGGTCCCGTAACGGCAGACGTACAAC
TTTCCAGGGCCAATCCCTACGCTGTCATAA|CCATCGTACGGTCTGACTTCTTTCCAGGGA
TATCAAATGTACATATTCCTCCAATAGAGG|CAACGAATCATATAGCGTACTTCCCCTACT
AGCCCTACGGTCTGGGCGAAATGGAATCGC|TCGTACGGTCTGACTTCTTTCCAGGGAGTG
GGGTTGGCAGGTTGCTCCCCCCGGGGGTAC|GACTTCTTTCCAGGGCTTCCATCGTACGGT
CGGTCCACAGGCATATGTCCATCGTACGGT|TTTATTCTATCCATCGTACGGTCTGACTTC
CCGTCCATCGTACGGTCTGACTTCTTTCCA|AATAAGGGTTCCCAGACTTTGCGAGGTAAT
CATTCGGATCCCATTATCGGAGGGTCCATC|GTTGCTCCCCCCGGGGGTACGCTTCTGCAA
AAGTTCTAATCCATCGTACGGTCTGACTTC|TACGGTCTGACTTCTTTCCAGGGTAGCTCA
ACGGCCTGCCCGTCGCTTATTGTTAGCCCT|CGACGGTCCACAGGCATATGTCCATCGTAC
AAGTAAACGTCCATCGTACGGTCTGACTTC|CCATGCAAGTAGTGCTCCGACAAACATTGG
ACGGCAGACGTACAACGAATCATATAGCGT|GTCGCTTATTGTTAGCCCTACGGTCTGGGC
GACACATTTCCCTATAAGCTTCCCATACCA|TATGGCGTAGGCCTTACGCATGCAAGTAAA
GCTACATTCCTTTACCTGAGTCAAATCAGT|GGTCCACGGGCGTGCTGTTTGGGAAACAAT
CTCTTGGGGACGCCATTTTATCACGTAAAA|TCCTACAGCTCTGTTCGGTTCGTCGCGAAC
GACTTCTTTCCAGGGCCAATCCCTACGCTG|GGATGTCCATCGTACGGTCTGACTTCTTTC
CTACATTCCTTTACCTGAGTCAAATCAGTT|GTCCACGGGCGTGCTGTTTGGGAAACAATC
TCCCTATAAGCTTCCCATACCATGCTACTT|AGGCCTTACGCATGCAAGTAAACGTCCATC
TTCCAGGGCGGGTCCCGTAACGGCAGACGT|GATCACATACGGCCTGCCCGTCGCTTATTG
ACGGTCTGACTTCTTTCCAGGGTCTTATAG|GGTCTGTAATTCCTCCATCGTACGGTCTGA
GATGGTGAATGCTACATTCCTTTACCTGAG|CTTTCCAGGGGGTCCACGGGCGTGCTGTTT
ACAACGAATCATATAGCGTACTTCCCCTAC|TTAGCCCTACGGTCTGGGCGAAATGGAATC
TTGCGAGGTAATGGTGGTTCCATCGTACGG|CGTACGGTCTGACTTCTTTCCAGGGCGGAA
TCGCTTATTGTTAGCCCTACGGTCTGGGCG|GGCATATGTCCATCGTACGGTCTGACTTCT
GTACGGTCTGACTTCTTTCCAGGGGGTCCA|GCCCAATCACTTGGTCGTGCGAGGATGTAT
CCGTCGTGATCATGATCCATCGTACGGTCT|GATCCCATTATCGGAGGGTCCATCGTACGG
CTGACTTCTTTCCAGGGAGTGCAGAGGCTG|TTTCCAGGGCCAATCCCTACGCTGTCATAA
AACGGATCACCCGCCTCATCGAAGCAAGGG|CTACTTCAAGTTCTAATCCATCGTACGGTC
CGAACGGATCACCCGCCTCATCGAAGCAAG|TGCTACTTCAAGTTCTAATCCATCGTACGG
CGGGTCTGTAATTCCTCCATCGTACGGTCT|AAGCAAGGGCCCGCGCCCTAGGCCCAATCA
ATGCTACTTCAAGTTCTAATCCATCGTACG|ACGTCCATCGTACGGTCTGACTTCTTTCCA
TTTAACATCGCCCCAGCCCGTCTCCATTCG|CTGACTTCTTTCCAGGGTTGGCAGGTTGCT
AAAACCCCGGCGTGCGATAGCTCGGGTCTG|GAACGGATCACCCGCCTCATCGAAGCAAGG
CGGCGTGCGATAGCTCGGGTCTGTAATTCC|TCACCCGCCTCATCGAAGCAAGGGCCCGCG
TCTGACTTCTTTCCAGGGCGGAATCCATCG|ATCAGTTGTCCTGCTCTTGGGGACGCCATT
CGCGAACGGATCACCCGCCTCATCGAAGCA|CATGCTACTTCAAGTTCTAATCCATCGTAC
GGTCTGACTTCTTTCCAGGGCCAATCCCTA|CCATAGGATGTCCATCGTACGGTCTGACTT
GAATGCTACATTCCTTTACCTGAGTCAAAT|AGGGGGTCCACGGGCGTGCTGTTTGGGAAA
CATCGTACGGTCTGACTTCTTTCCAGGGTA|GTGCTCCGACAAACATTGGATTAGCCCGAG
TTGTCCTGCTCTTGGGGACGCCATTTTATC|TCCACTGATCCTACAGCTCTGTTCGGTTCG
TCCAATAGAGGACACATTTCCCTATAAGCT|CTTCCCCTACTATGGCGTAGGCCTTACGCA
TCTTTCCAGGGTCTTATAGGAGGATGGTGA|CCTCCATCGTACGGTCTGACTTCTTTCCAG
GTAAAACCCCGGCGTGCGATAGCTCGGGTC|GCGAACGGATCACCCGCCTCATCGAAGCAA
TTCCAGGGCGGAATCCATCGTACGGTCTGA|CTGCTCTTGGGGACGCCATTTTATCACGTA
GCGTAGGCCTTACGCATGCAAGTAAACGTC|GAGTCCTTGATTAACAATCCCATGCAAGTA
CCCCAGCCCGTCTCCATTCGGATCCCATTA|TCCAGGGTTGGCAGGTTGCTCCCCCCGGGG
AATCAGTTGTCCTGCTCTTGGGGACGCCAT|AAACAATCCACTGATCCTACAGCTCTGTTC
CCCATGCAAGTAGTGCTCCGACAAACATTG|CATCGTACGGTCTGACTTCTTTCCAGGGGT
CGAGGATGTATCAAATGTACATATTCCTCC|CAGACGTACAACGAATCATATAGCGTACTT
GGCGTAGGCCTTACGCATGCAAGTAAACGT|AGAGTCCTTGATTAACAATCCCATGCAAGT
TCCAGGGCGGGTCCCGTAACGGCAGACGTA|ATCACATACGGCCTGCCCGTCGCTTATTGT
CGTACGGTCTGACTTCTTTCCAGGGCGGAA|GAGTCAAATCAGTTGTCCTGCTCTTGGGGA
GTACGGTCTGACTTCTTTCCAGGGCATGTA|TCCCAGACTTTGCGAGGTAATGGTGGTTCC
TGGACCGTCCATCGTACGGTCTGACTTCTT|GTCAAATAAGGGTTCCCAGACTTTGCGAGG
AACATCGCCCCAGCCCGTCTCCATTCGGAT|ACTTCTTTCCAGGGTTGGCAGGTTGCTCCC
ACTTCTTTCCAGGGCTTCCATCGTACGGTC|AAAACCCCGGCGTGCGATAGCTCGGGTCTG
ATCGTACGGTCTGACTTCTTTCCAGGGCTT|CATTTTATCACGTAAAACCCCGGCGTGCGA
AGGATGGTGAATGCTACATTCCTTTACCTG|TTCTTTCCAGGGGGTCCACGGGCGTGCTGT
TTCTTTCCAGGGCATGTACAGGCTGAATTT|CGAGGTAATGGTGGTTCCATCGTACGGTCT
ACAGGCATATGTCCATCGTACGGTCTGACT|CTATCCATCGTACGGTCTGACTTCTTTCCA
CAAATCAGTTGTCCTGCTCTTGGGGACGCC|GGAAACAATCCACTGATCCTACAGCTCTGT
TTTCCAGGGCATGTACAGGCTGAATTTTAA|GGTAATGGTGGTTCCATCGTACGGTCTGAC
CAAATGGCACATGACGACGGTCCACAGGCA|GAAGACCTACAAGTCGCTTTATTCTATCCA
ATATCCATCGTACGGTCTGACTTCTTTCCA|TGTTCCACCCCGAAGCAACTCCATCGTACG
CGAAGCAACTCCATCGTACGGTCTGACTTC|AGCTATATGCTGAGATTGAATCCACACGTG
CTTTGCGAGGTAATGGTGGTTCCATCGTAC|ATCGTACGGTCTGACTTCTTTCCAGGGCGG
TAGGCCTTACGCATGCAAGTAAACGTCCAT|TCCTTGATTAACAATCCCATGCAAGTAGTG
CGGTCTGACTTCTTTCCAGGGTTTGGACCG|GTACGGTCTGACTTCTTTCCAGGGTCAAAT
GAATTTTAACATCGCCCCAGCCCGTCTCCA|CGGTCTGACTTCTTTCCAGGGTTGGCAGGT
AAGCTTCCCATACCATGCTACTTCAAGTTC|ACGCATGCAAGTAAACGTCCATCGTACGGT
ACAAACATTGGATTAGCCCGAGCAAATGGC|TTCCAGGGGTGCCGTATTTTGGGAAGACCT
TCTGACTTCTTTCCAGGGTCTTATAGGAGG|TGTAATTCCTCCATCGTACGGTCTGACTTC
TGACTTCTTTCCAGGGCATGTACAGGCTGA|TTTGCGAGGTAATGGTGGTTCCATCGTACG
CGAGGTAATGGTGGTTCCATCGTACGGTCT|ACGGTCTGACTTCTTTCCAGGGCGGAATCC
ACCGTCCATCGTACGGTCTGACTTCTTTCC|AAATAAGGGTTCCCAGACTTTGCGAGGTAA
ATTCGGATCCCATTATCGGAGGGTCCATCG|TTGCTCCCCCCGGGGGTACGCTTCTGCAAC
GGGAAGACCTACAAGTCGCTTTATTCTATC|AGGGGCACGTTGAGAGCAACATAATCGAAG
ACATTTCCCTATAAGCTTCCCATACCATGC|GGCGTAGGCCTTACGCATGCAAGTAAACGT
TAGCCCTACGGTCTGGGCGAAATGGAATCG|ATCGTACGGTCTGACTTCTTTCCAGGGAGT
GTCTGACTTCTTTCCAGGGCTTCCATCGTA|CACGTAAAACCCCGGCGTGCGATAGCTCGG
ATCGAAGCAAGGGCCCGCGCCCTAGGCCCA|CCATCGTACGGTCTGACTTCTTTCCAGGGC
GCTGAGGGGAATATCCATCGTACGGTCTGA|ATAATTGTAGTGTTCCACCCCGAAGCAACT
TACGGTCTGACTTCTTTCCAGGGCGGGTCC|TCCAGGGTAGCTCAAGATCACATACGGCCT
ACTTCTTTCCAGGGTCTTATAGGAGGATGG|ATTCCTCCATCGTACGGTCTGACTTCTTTC
TCTTATAGGAGGATGGTGAATGCTACATTC|CGGTCTGACTTCTTTCCAGGGGGTCCACGG
GACGCCATTTTATCACGTAAAACCCCGGCG|CTCTGTTCGGTTCGTCGCGAACGGATCACC
AGTCGCTTTATTCTATCCATCGTACGGTCT|GAGCAACATAATCGAAGATGGCTTTCCATA
ATGGCACATGACGACGGTCCACAGGCATAT|GACCTACAAGTCGCTTTATTCTATCCATCG
CGTACGGTCTGACTTCTTTCCAGGGTCTTA|TCGGGTCTGTAATTCCTCCATCGTACGGTC
TTTCCAGGGTAGCTCAAGATCACATACGGC|ATTAGCCCGAGCAAATGGCACATGACGACG
TCGGTTCGTCGCGAACGGATCACCCGCCTC|TTCCCATACCATGCTACTTCAAGTTCTAAT
TCGCCTTATAGAAATGGCAGGAAACCGCAG|CAGGGTCTTATAGGAGGATGGTGAATGCTA
AGTGCTCCGACAAACATTGGATTAGCCCGA|CTGACTTCTTTCCAGGGGTGCCGTATTTTG
TTCTTTCCAGGGCCAATCCCTACGCTGTCA|TGTCCATCGTACGGTCTGACTTCTTTCCAG
TCCCAGACTTTGCGAGGTAATGGTGGTTCC|TCCTTCCATCGTACGGTCTGACTTCTTTCC
AACATTGGATTAGCCCGAGCAAATGGCACA|CAGGGGTGCCGTATTTTGGGAAGACCTACA
GGGGTACGCTTCTGCAACTTCGCCTTATAG|GTACGGTCTGACTTCTTTCCAGGGTCTTAT
TGAATGCTACATTCCTTTACCTGAGTCAAA|CAGGGGGTCCACGGGCGTGCTGTTTGGGAA
TACTTCCCCTACTATGGCGTAGGCCTTACG|CGAAATGGAATCGCAAGAGTCCTTGATTAA
CCTATAAGCTTCCCATACCATGCTACTTCA|GCCTTACGCATGCAAGTAAACGTCCATCGT
AACTCCATCGTACGGTCTGACTTCTTTCCA|ATGCTGAGATTGAATCCACACGTGTGTTGC
CTTCGCCTTATAGAAATGGCAGGAAACCGC|TCCAGGGTCTTATAGGAGGATGGTGAATGC
TAGCGTACTTCCCCTACTATGGCGTAGGCC|CTGGGCGAAATGGAATCGCAAGAGTCCTTG
CAACTTCGCCTTATAGAAATGGCAGGAAAC|CTTTCCAGGGTCTTATAGGAGGATGGTGAA
CTGCTCTTGGGGACGCCATTTTATCACGTA|TGATCCTACAGCTCTGTTCGGTTCGTCGCG
CAGGGAGTGCAGAGGCTGAGGGGAATATCC|ATCCCTACGCTGTCATAATTGTAGTGTTCC
AGAAATGGCAGGAAACCGCAGGAGATCCTT|ATAGGAGGATGGTGAATGCTACATTCCTTT
ATATTCCTCCAATAGAGGACACATTTCCCT|TAGCGTACTTCCCCTACTATGGCGTAGGCC
GACTTCTTTCCAGGGCGGGTCCCGTAACGG|AGCTCAAGATCACATACGGCCTGCCCGTCG
CAGGGTCTTATAGGAGGATGGTGAATGCTA|TCGTACGGTCTGACTTCTTTCCAGGGGGTC
GGTTCGTCGCGAACGGATCACCCGCCTCAT|CCCATACCATGCTACTTCAAGTTCTAATCC
TAGCTCAAGATCACATACGGCCTGCCCGTC|AGCAAATGGCACATGACGACGGTCCACAGG
GTTTGGACCGTCCATCGTACGGTCTGACTT|AGGGTCAAATAAGGGTTCCCAGACTTTGCG
TGACGACGGTCCACAGGCATATGTCCATCG|AGTCGCTTTATTCTATCCATCGTACGGTCT
CGTCGCTTATTGTTAGCCCTACGGTCTGGG|CAGGCATATGTCCATCGTACGGTCTGACTT
ACGAATCATATAGCGTACTTCCCCTACTAT|GCCCTACGGTCTGGGCGAAATGGAATCGCA
TGGTCGTGCGAGGATGTATCAAATGTACAT|CGTAACGGCAGACGTACAACGAATCATATA
GGGCCAATCCCTACGCTGTCATAATTGTAG|TACGGTCTGACTTCTTTCCAGGGAGTACGC
AGCTCTGTTCGGTTCGTCGCGAACGGATCA|CTATAAGCTTCCCATACCATGCTACTTCAA
CGCTTCTGCAACTTCGCCTTATAGAAATGG|TCTGACTTCTTTCCAGGGTCTTATAGGAGG
AGGGTTCCCAGACTTTGCGAGGTAATGGTG|GGAGATCCTTCCATCGTACGGTCTGACTTC
TCTTTCCAGGGTTGGCAGGTTGCTCCCCCC|TACGGTCTGACTTCTTTCCAGGGCTTCCAT
TCCCATTATCGGAGGGTCCATCGTACGGTC|CCCCGGGGGTACGCTTCTGCAACTTCGCCT
CTACAGCTCTGTTCGGTTCGTCGCGAACGG|TTCCCTATAAGCTTCCCATACCATGCTACT
ACGTAAAACCCCGGCGTGCGATAGCTCGGG|TCGCGAACGGATCACCCGCCTCATCGAAGC
GTGAATGCTACATTCCTTTACCTGAGTCAA|CCAGGGGGTCCACGGGCGTGCTGTTTGGGA
CGGTCTGACTTCTTTCCAGGGAGTGCAGAG|CTTCTTTCCAGGGCCAATCCCTACGCTGTC
GGAGGATGGTGAATGCTACATTCCTTTACC|ACTTCTTTCCAGGGGGTCCACGGGCGTGCT
CTTCTTTCCAGGGGGTCCACGGGCGTGCTG|TGGTCGTGCGAGGATGTATCAAATGTACAT
GTAAACGTCCATCGTACGGTCTGACTTCTT|ATGCAAGTAGTGCTCCGACAAACATTGGAT
ACCATGCTACTTCAAGTTCTAATCCATCGT|TAAACGTCCATCGTACGGTCTGACTTCTTT
CCAGCCCGTCTCCATTCGGATCCCATTATC|CAGGGTTGGCAGGTTGCTCCCCCCGGGGGT
CCAGGGTCAAATAAGGGTTCCCAGACTTTG|GCAGGAAACCGCAGGAGATCCTTCCATCGT
TTTTGGGAAGACCTACAAGTCGCTTTATTC|TTCCAGGGGCACGTTGAGAGCAACATAATC
TTCCAGGGCCAATCCCTACGCTGTCATAAT|CATCGTACGGTCTGACTTCTTTCCAGGGAG
GACTTCTTTCCAGGGTCAAATAAGGGTTCC|ATAGAAATGGCAGGAAACCGCAGGAGATCC
GTTCGGTTCGTCGCGAACGGATCACCCGCC|GCTTCCCATACCATGCTACTTCAAGTTCTA
TTGGGGACGCCATTTTATCACGTAAAACCC|TACAGCTCTGTTCGGTTCGTCGCGAACGGA
TCCAGGGGTGCCGTATTTTGGGAAGACCTA|TACGGTCTGACTTCTTTCCAGGGGCACGTT
ACGGTCTGACTTCTTTCCAGGGCTTCCATC|TATCACGTAAAACCCCGGCGTGCGATAGCT
GTTAGCCCTACGGTCTGGGCGAAATGGAAT|CCATCGTACGGTCTGACTTCTTTCCAGGGA
CTGACTTCTTTCCAGGGTTGGCAGGTTGCT|CCATCGTACGGTCTGACTTCTTTCCAGGGC
GAGGGGAATATCCATCGTACGGTCTGACTT|ATTGTAGTGTTCCACCCCGAAGCAACTCCA
AATGGCAGGAAACCGCAGGAGATCCTTCCA|GGAGGATGGTGAATGCTACATTCCTTTACC
GCAGACGTACAACGAATCATATAGCGTACT|GCTTATTGTTAGCCCTACGGTCTGGGCGAA
TCTGGGCGAAATGGAATCGCAAGAGTCCTT|TGACTTCTTTCCAGGGAGTGCAGAGGCTGA
AAACATTGGATTAGCCCGAGCAAATGGCAC|CCAGGGGTGCCGTATTTTGGGAAGACCTAC
TCTTTCCAGGGTTTGGACCGTCCATCGTAC|ACTTCTTTCCAGGGTCAAATAAGGGTTCCC
AATCCACTGATCCTACAGCTCTGTTCGGTT|TAGAGGACACATTTCCCTATAAGCTTCCCA
CCATGCTACTTCAAGTTCTAATCCATCGTA|AAACGTCCATCGTACGGTCTGACTTCTTTC
CATGCAAGTAAACGTCCATCGTACGGTCTG|CAATCCCATGCAAGTAGTGCTCCGACAAAC
AATGGCACATGACGACGGTCCACAGGCATA|AGACCTACAAGTCGCTTTATTCTATCCATC
ATCGTACGGTCTGACTTCTTTCCAGGGTCT|GCTCGGGTCTGTAATTCCTCCATCGTACGG
TCTGACTTCTTTCCAGGGGTGCCGTATTTT|CAACTCCATCGTACGGTCTGACTTCTTTCC
GTGCGAGGATGTATCAAATGTACATATTCC|CGGCAGACGTACAACGAATCATATAGCGTA
AACAATCCACTGATCCTACAGCTCTGTTCG|CAATAGAGGACACATTTCCCTATAAGCTTC
GTGTTCCACCCCGAAGCAACTCCATCGTAC|CTCCGGCCCAGAGCTATATGCTGAGATTGA
TCTAATCCATCGTACGGTCTGACTTCTTTC|GTCTGACTTCTTTCCAGGGTAGCTCAAGAT
CAGCCCGTCTCCATTCGGATCCCATTATCG|AGGGTTGGCAGGTTGCTCCCCCCGGGGGTA
TGACTTCTTTCCAGGGGGTCCACGGGCGTG|ACTTGGTCGTGCGAGGATGTATCAAATGTA
GTCGTGCGAGGATGTATCAAATGTACATAT|TAACGGCAGACGTACAACGAATCATATAGC
CAGGGGTGCCGTATTTTGGGAAGACCTACA|CGGTCTGACTTCTTTCCAGGGGCACGTTGA
TCCATTCGGATCCCATTATCGGAGGGTCCA|AGGTTGCTCCCCCCGGGGGTACGCTTCTGC
GGTCAAATAAGGGTTCCCAGACTTTGCGAG|GAAACCGCAGGAGATCCTTCCATCGTACGG
GCCTTATAGAAATGGCAGGAAACCGCAGGA|GGGTCTTATAGGAGGATGGTGAATGCTACA
GGAATCGCAAGAGTCCTTGATTAACAATCC|AGGGAGTGCAGAGGCTGAGGGGAATATCCA
GACTTCTTTCCAGGGTTGGCAGGTTGCTCC|ATCGTACGGTCTGACTTCTTTCCAGGGCTT
AGGGTAGCTCAAGATCACATACGGCCTGCC|CCCGAGCAAATGGCACATGACGACGGTCCA
ACTTCCCCTACTATGGCGTAGGCCTTACGC|GAAATGGAATCGCAAGAGTCCTTGATTAAC
GGTCTGACTTCTTTCCAGGGTCAAATAAGG|GCCTTATAGAAATGGCAGGAAACCGCAGGA
TCCATCGTACGGTCTGACTTCTTTCCAGGG|AGATGGCTTTCCATAGGATGTCCATCGTAC
GAGTCAAATCAGTTGTCCTGCTCTTGGGGA|TTTGGGAAACAATCCACTGATCCTACAGCT
GTCTGACTTCTTTCCAGGGCGGAATCCATC|AATCAGTTGTCCTGCTCTTGGGGACGCCAT
GACTTCTTTCCAGGGTAGCTCAAGATCACA|CATTGGATTAGCCCGAGCAAATGGCACATG
TTAACAATCCCATGCAAGTAGTGCTCCGAC|GGAATATCCATCGTACGGTCTGACTTCTTT
CCATCGTACGGTCTGACTTCTTTCCAGGGT|GGTCCATCGTACGGTCTGACTTCTTTCCAG
TACGGTCTGACTTCTTTCCAGGGAGTGCAG|GACTTCTTTCCAGGGCCAATCCCTACGCTG
ACCCCGGCGTGCGATAGCTCGGGTCTGTAA|CGGATCACCCGCCTCATCGAAGCAAGGGCC
TTAGCCCTACGGTCTGGGCGAAATGGAATC|CATCGTACGGTCTGACTTCTTTCCAGGGAG
TCTTTCCAGGGGTGCCGTATTTTGGGAAGA|ATCGTACGGTCTGACTTCTTTCCAGGGGCA
AGGGCGGAATCCATCGTACGGTCTGACTTC|TCTTGGGGACGCCATTTTATCACGTAAAAC
CCATCGTACGGTCTGACTTCTTTCCAGGGC|GATGGCTTTCCATAGGATGTCCATCGTACG
TGGGCGAAATGGAATCGCAAGAGTCCTTGA|ACTTCTTTCCAGGGAGTGCAGAGGCTGAGG
GGTCCCGTAACGGCAGACGTACAACGAATC|GGCCTGCCCGTCGCTTATTGTTAGCCCTAC
ATGGTGGTTCCATCGTACGGTCTGACTTCT|GACTTCTTTCCAGGGCGGAATCCATCGTAC
GCAACTTCGCCTTATAGAAATGGCAGGAAA|TCTTTCCAGGGTCTTATAGGAGGATGGTGA
GACTTTGCGAGGTAATGGTGGTTCCATCGT|CCATCGTACGGTCTGACTTCTTTCCAGGGC
ATCGCAAGAGTCCTTGATTAACAATCCCAT|GAGTGCAGAGGCTGAGGGGAATATCCATCG
ATTCCTTTACCTGAGTCAAATCAGTTGTCC|ACGGGCGTGCTGTTTGGGAAACAATCCACT
GGAGTGCAGAGGCTGAGGGGAATATCCATC|CCTACGCTGTCATAATTGTAGTGTTCCACC
AGTTGTCCTGCTCTTGGGGACGCCATTTTA|AATCCACTGATCCTACAGCTCTGTTCGGTT
CTCAAGATCACATACGGCCTGCCCGTCGCT|AAATGGCACATGACGACGGTCCACAGGCAT
GAGGATGGTGAATGCTACATTCCTTTACCT|CTTCTTTCCAGGGGGTCCACGGGCGTGCTG
ATACCATGCTACTTCAAGTTCTAATCCATC|AGTAAACGTCCATCGTACGGTCTGACTTCT
TGCTACATTCCTTTACCTGAGTCAAATCAG|GGGTCCACGGGCGTGCTGTTTGGGAAACAA
GGCGTGCGATAGCTCGGGTCTGTAATTCCT|CACCCGCCTCATCGAAGCAAGGGCCCGCGC
TCCATCGTACGGTCTGACTTCTTTCCAGGG|CTGAGATTGAATCCACACGTGTGTTGCCTT
GGGGTCCACGGGCGTGCTGTTTGGGAAACA|GGATGTATCAAATGTACATATTCCTCCAAT
CATTATCGGAGGGTCCATCGTACGGTCTGA|CGGGGGTACGCTTCTGCAACTTCGCCTTAT
AGTGTTCCACCCCGAAGCAACTCCATCGTA|GCTCCGGCCCAGAGCTATATGCTGAGATTG
CCTTGATTAACAATCCCATGCAAGTAGTGC|CTGAGGGGAATATCCATCGTACGGTCTGAC
TCCACCCCGAAGCAACTCCATCGTACGGTC|GGCCCAGAGCTATATGCTGAGATTGAATCC
TTCCCTATAAGCTTCCCATACCATGCTACT|TAGGCCTTACGCATGCAAGTAAACGTCCAT
TCCATCGTACGGTCTGACTTCTTTCCAGGG|CGCCATTTTATCACGTAAAACCCCGGCGTG
CCCGTCTCCATTCGGATCCCATTATCGGAG|GTTGGCAGGTTGCTCCCCCCGGGGGTACGC
TGTATCAAATGTACATATTCCTCCAATAGA|TACAACGAATCATATAGCGTACTTCCCCTA
AGACCTACAAGTCGCTTTATTCTATCCATC|GCACGTTGAGAGCAACATAATCGAAGATGG
CAAGATCACATACGGCCTGCCCGTCGCTTA|ATGGCACATGACGACGGTCCACAGGCATAT
TTTGGACCGTCCATCGTACGGTCTGACTTC|GGGTCAAATAAGGGTTCCCAGACTTTGCGA
ATCACATACGGCCTGCCCGTCGCTTATTGT|CACATGACGACGGTCCACAGGCATATGTCC
TTTGGGAAACAATCCACTGATCCTACAGCT|ATTCCTCCAATAGAGGACACATTTCCCTAT
GCTCGGGTCTGTAATTCCTCCATCGTACGG|TCGAAGCAAGGGCCCGCGCCCTAGGCCCAA
CCCCGGGGGTACGCTTCTGCAACTTCGCCT|CCATCGTACGGTCTGACTTCTTTCCAGGGT
TGGGAAACAATCCACTGATCCTACAGCTCT|TCCTCCAATAGAGGACACATTTCCCTATAA
CCTCATCGAAGCAAGGGCCCGCGCCCTAGG|TAATCCATCGTACGGTCTGACTTCTTTCCA
TGGATTAGCCCGAGCAAATGGCACATGACG|GTGCCGTATTTTGGGAAGACCTACAAGTCG
GGTCCATCGTACGGTCTGACTTCTTTCCAG|TTCTGCAACTTCGCCTTATAGAAATGGCAG
CCAGGGAGTGCAGAGGCTGAGGGGAATATC|AATCCCTACGCTGTCATAATTGTAGTGTTC
CCCCCGGGGGTACGCTTCTGCAACTTCGCC|TCCATCGTACGGTCTGACTTCTTTCCAGGG
CGCAAGAGTCCTTGATTAACAATCCCATGC|GTGCAGAGGCTGAGGGGAATATCCATCGTA
CTTTCCAGGGTCTTATAGGAGGATGGTGAA|CTCCATCGTACGGTCTGACTTCTTTCCAGG
TCTTTCCAGGGAGTGCAGAGGCTGAGGGGA|GGGCCAATCCCTACGCTGTCATAATTGTAG
ACGGTCTGACTTCTTTCCAGGGCGGAATCC|TCAAATCAGTTGTCCTGCTCTTGGGGACGC
CCGGCGTGCGATAGCTCGGGTCTGTAATTC|ATCACCCGCCTCATCGAAGCAAGGGCCCGC
AGCTTCCCATACCATGCTACTTCAAGTTCT|CGCATGCAAGTAAACGTCCATCGTACGGTC
ACTTCTTTCCAGGGCGGAATCCATCGTACG|GTTGTCCTGCTCTTGGGGACGCCATTTTAT
GCTGTTTGGGAAACAATCCACTGATCCTAC|ACATATTCCTCCAATAGAGGACACATTTCC
TTTTAACATCGCCCCAGCCCGTCTCCATTC|TCTGACTTCTTTCCAGGGTTGGCAGGTTGC
GATAGCTCGGGTCTGTAATTCCTCCATCGT|CTCATCGAAGCAAGGGCCCGCGCCCTAGGC
GTACGGTCTGACTTCTTTCCAGGGGTGCCG|CCGAAGCAACTCCATCGTACGGTCTGACTT
ACGCTGTCATAATTGTAGTGTTCCACCCCG|TCTTTCCAGGGAGTACGCTCCGGCCCAGAG
CTCCCCCCGGGGGTACGCTTCTGCAACTTC|GCTTCCATCGTACGGTCTGACTTCTTTCCA
TCCATCGTACGGTCTGACTTCTTTCCAGGG|TCCAGGGCGGAATCCATCGTACGGTCTGAC
CCGTCGCTTATTGTTAGCCCTACGGTCTGG|ACAGGCATATGTCCATCGTACGGTCTGACT
GCAAGTAAACGTCCATCGTACGGTCTGACT|TCCCATGCAAGTAGTGCTCCGACAAACATT
CATGTACAGGCTGAATTTTAACATCGCCCC|GGTTCCATCGTACGGTCTGACTTCTTTCCA
GTCCCGTAACGGCAGACGTACAACGAATCA|GCCTGCCCGTCGCTTATTGTTAGCCCTACG
TCTGACTTCTTTCCAGGGCGGGTCCCGTAA|GGTAGCTCAAGATCACATACGGCCTGCCCG
CCTGCCCGTCGCTTATTGTTAGCCCTACGG|GGTCCACAGGCATATGTCCATCGTACGGTC
CGGAGGGTCCATCGTACGGTCTGACTTCTT|TACGCTTCTGCAACTTCGCCTTATAGAAAT
AACGAATCATATAGCGTACTTCCCCTACTA|AGCCCTACGGTCTGGGCGAAATGGAATCGC
GTTCCCAGACTTTGCGAGGTAATGGTGGTT|GATCCTTCCATCGTACGGTCTGACTTCTTT
CATCGTACGGTCTGACTTCTTTCCAGGGAG|GGTCTGACTTCTTTCCAGGGCCAATCCCTA
CCTACTATGGCGTAGGCCTTACGCATGCAA|GAATCGCAAGAGTCCTTGATTAACAATCCC
TGTTCGGTTCGTCGCGAACGGATCACCCGC|AGCTTCCCATACCATGCTACTTCAAGTTCT
ATCGTACGGTCTGACTTCTTTCCAGGGGTG|ACCCCGAAGCAACTCCATCGTACGGTCTGA
GGTCGTGCGAGGATGTATCAAATGTACATA|GTAACGGCAGACGTACAACGAATCATATAG
CATCGCCCCAGCCCGTCTCCATTCGGATCC|TTCTTTCCAGGGTTGGCAGGTTGCTCCCCC
CTTTCCAGGGGGTCCACGGGCGTGCTGTTT|TCGTGCGAGGATGTATCAAATGTACATATT
GACTTCTTTCCAGGGTTTGGACCGTCCATC|TCTGACTTCTTTCCAGGGTCAAATAAGGGT
CCATCGTACGGTCTGACTTCTTTCCAGGGA|CGGTCTGACTTCTTTCCAGGGCCAATCCCT
GCATATGTCCATCGTACGGTCTGACTTCTT|CCATCGTACGGTCTGACTTCTTTCCAGGGC
CCATCGTACGGTCTGACTTCTTTCCAGGGC|GCCATTTTATCACGTAAAACCCCGGCGTGC
ACACATTTCCCTATAAGCTTCCCATACCAT|ATGGCGTAGGCCTTACGCATGCAAGTAAAC
TTTGCGAGGTAATGGTGGTTCCATCGTACG|TCGTACGGTCTGACTTCTTTCCAGGGCGGA
GTGCTCCGACAAACATTGGATTAGCCCGAG|TGACTTCTTTCCAGGGGTGCCGTATTTTGG
AGCAAGGGCCCGCGCCCTAGGCCCAATCAC|GTACGGTCTGACTTCTTTCCAGGGCGGGTC
GTCGTGATCATGATCCATCGTACGGTCTGA|TCCCATTATCGGAGGGTCCATCGTACGGTC
TATCGGAGGGTCCATCGTACGGTCTGACTT|GGGTACGCTTCTGCAACTTCGCCTTATAGA
GGAAACCGCAGGAGATCCTTCCATCGTACG|GGTGAATGCTACATTCCTTTACCTGAGTCA
CCATCGTACGGTCTGACTTCTTTCCAGGGT|TAGCTCGGGTCTGTAATTCCTCCATCGTAC
CCAATCACTTGGTCGTGCGAGGATGTATCA|GGCGGGTCCCGTAACGGCAGACGTACAACG
AGGCATATGTCCATCGTACGGTCTGACTTC|ATCCATCGTACGGTCTGACTTCTTTCCAGG
GCAAGTAGTGCTCCGACAAACATTGGATTA|TACGGTCTGACTTCTTTCCAGGGGTGCCGT
GGTAGCTCAAGATCACATACGGCCTGCCCG|CGAGCAAATGGCACATGACGACGGTCCACA
TTTCCAGGGGGTCCACGGGCGTGCTGTTTG|CGTGCGAGGATGTATCAAATGTACATATTC
TCTGACTTCTTTCCAGGGCATGTACAGGCT|ACTTTGCGAGGTAATGGTGGTTCCATCGTA
AAGTAGTGCTCCGACAAACATTGGATTAGC|CGGTCTGACTTCTTTCCAGGGGTGCCGTAT
GTCTGACTTCTTTCCAGGGTCAAATAAGGG|CCTTATAGAAATGGCAGGAAACCGCAGGAG
CAGTTGTCCTGCTCTTGGGGACGCCATTTT|CAATCCACTGATCCTACAGCTCTGTTCGGT
GGTCTGACTTCTTTCCAGGGTTGGCAGGTT|AATCCATCGTACGGTCTGACTTCTTTCCAG
CCGAGCAAATGGCACATGACGACGGTCCAC|TTTGGGAAGACCTACAAGTCGCTTTATTCT
GCAGGTTGCTCCCCCCGGGGGTACGCTTCT|TTTCCAGGGCTTCCATCGTACGGTCTGACT
CAGGGTTGGCAGGTTGCTCCCCCCGGGGGT|CTGACTTCTTTCCAGGGCTTCCATCGTACG
GGTGAATGCTACATTCCTTTACCTGAGTCA|TCCAGGGGGTCCACGGGCGTGCTGTTTGGG
GAGATCCTTCCATCGTACGGTCTGACTTCT|CATTCCTTTACCTGAGTCAAATCAGTTGTC
GCCCAATCACTTGGTCGTGCGAGGATGTAT|AGGGCGGGTCCCGTAACGGCAGACGTACAA
AGGAGGATGGTGAATGCTACATTCCTTTAC|GACTTCTTTCCAGGGGGTCCACGGGCGTGC
GTGCCGTATTTTGGGAAGACCTACAAGTCG|TGACTTCTTTCCAGGGGCACGTTGAGAGCA
AGGGTCTTATAGGAGGATGGTGAATGCTAC|CGTACGGTCTGACTTCTTTCCAGGGGGTCC
CAGGCTGAATTTTAACATCGCCCCAGCCCG|ATCGTACGGTCTGACTTCTTTCCAGGGTTG
AAGCAAGGGCCCGCGCCCTAGGCCCAATCA|CGTACGGTCTGACTTCTTTCCAGGGCGGGT
TACGCATGCAAGTAAACGTCCATCGTACGG|TTAACAATCCCATGCAAGTAGTGCTCCGAC
TACGGCCTGCCCGTCGCTTATTGTTAGCCC|ACGACGGTCCACAGGCATATGTCCATCGTA
ATCGTACGGTCTGACTTCTTTCCAGGGTTG|AGGGCGGAATCCATCGTACGGTCTGACTTC
CATCGTACGGTCTGACTTCTTTCCAGGGGG|CTAGGCCCAATCACTTGGTCGTGCGAGGAT
GCCAATCCCTACGCTGTCATAATTGTAGTG|CGGTCTGACTTCTTTCCAGGGAGTACGCTC
GGTAATGGTGGTTCCATCGTACGGTCTGAC|GTCTGACTTCTTTCCAGGGCGGAATCCATC
AGGTTGCTCCCCCCGGGGGTACGCTTCTGC|TCCAGGGCTTCCATCGTACGGTCTGACTTC
GGGTGCCGTATTTTGGGAAGACCTACAAGT|TCTGACTTCTTTCCAGGGGCACGTTGAGAG
CAGCTCTGTTCGGTTCGTCGCGAACGGATC|CCTATAAGCTTCCCATACCATGCTACTTCA
TCTGACTTCTTTCCAGGGTCAAATAAGGGT|CTTATAGAAATGGCAGGAAACCGCAGGAGA
GTCCACAGGCATATGTCCATCGTACGGTCT|TATTCTATCCATCGTACGGTCTGACTTCTT
TTGGACCGTCCATCGTACGGTCTGACTTCT|GGTCAAATAAGGGTTCCCAGACTTTGCGAG
CCTTATAGAAATGGCAGGAAACCGCAGGAG|GGTCTTATAGGAGGATGGTGAATGCTACAT
GCTCCCCCCGGGGGTACGCTTCTGCAACTT|GGCTTCCATCGTACGGTCTGACTTCTTTCC
TGACTTCTTTCCAGGGCGGAATCCATCGTA|CAGTTGTCCTGCTCTTGGGGACGCCATTTT
CCCTACGGTCTGGGCGAAATGGAATCGCAA|GTACGGTCTGACTTCTTTCCAGGGAGTGCA
CGTACGGTCTGACTTCTTTCCAGGGCTTCC|TTTTATCACGTAAAACCCCGGCGTGCGATA
TGACTTCTTTCCAGGGCGGGTCCCGTAACG|TAGCTCAAGATCACATACGGCCTGCCCGTC
CTTTCCAGGGAGTGCAGAGGCTGAGGGGAA|GGCCAATCCCTACGCTGTCATAATTGTAGT
CCTAGGCCCAATCACTTGGTCGTGCGAGGA|TTTCCAGGGCGGGTCCCGTAACGGCAGACG
ATAATTGTAGTGTTCCACCCCGAAGCAACT|GGGAGTACGCTCCGGCCCAGAGCTATATGC
GCTTCTGCAACTTCGCCTTATAGAAATGGC|CTGACTTCTTTCCAGGGTCTTATAGGAGGA
CCCGAGCAAATGGCACATGACGACGGTCCA|TTTTGGGAAGACCTACAAGTCGCTTTATTC
ATCCCATGCAAGTAGTGCTCCGACAAACAT|TCCATCGTACGGTCTGACTTCTTTCCAGGG
GTCATAATTGTAGTGTTCCACCCCGAAGCA|CCAGGGAGTACGCTCCGGCCCAGAGCTATA
GTTCTAATCCATCGTACGGTCTGACTTCTT|CGGTCTGACTTCTTTCCAGGGTAGCTCAAG
TGCAACTTCGCCTTATAGAAATGGCAGGAA|TTCTTTCCAGGGTCTTATAGGAGGATGGTG
GGTCTGACTTCTTTCCAGGGAGTGCAGAGG|TTCTTTCCAGGGCCAATCCCTACGCTGTCA
CCACTGATCCTACAGCTCTGTTCGGTTCGT|AGGACACATTTCCCTATAAGCTTCCCATAC
TCCCTACGCTGTCATAATTGTAGTGTTCCA|TGACTTCTTTCCAGGGAGTACGCTCCGGCC
GCTTATTGTTAGCCCTACGGTCTGGGCGAA|CATATGTCCATCGTACGGTCTGACTTCTTT
TCAAATCAGTTGTCCTGCTCTTGGGGACGC|GGGAAACAATCCACTGATCCTACAGCTCTG
GGCCCAATCACTTGGTCGTGCGAGGATGTA|CAGGGCGGGTCCCGTAACGGCAGACGTACA
CGGAATCCATCGTACGGTCTGACTTCTTTC|GGGGACGCCATTTTATCACGTAAAACCCCG
TGCCCGTCGCTTATTGTTAGCCCTACGGTC|TCCACAGGCATATGTCCATCGTACGGTCTG
CCCGAAGCAACTCCATCGTACGGTCTGACT|AGAGCTATATGCTGAGATTGAATCCACACG
TACGGTCTGACTTCTTTCCAGGGTTTGGAC|TCGTACGGTCTGACTTCTTTCCAGGGTCAA
TATCACGTAAAACCCCGGCGTGCGATAGCT|TTCGTCGCGAACGGATCACCCGCCTCATCG
TCTGACTTCTTTCCAGGGTTGGCAGGTTGC|TCCATCGTACGGTCTGACTTCTTTCCAGGG
GACCGTCCATCGTACGGTCTGACTTCTTTC|CAAATAAGGGTTCCCAGACTTTGCGAGGTA
GAATATCCATCGTACGGTCTGACTTCTTTC|AGTGTTCCACCCCGAAGCAACTCCATCGTA
TTTGGGAAGACCTACAAGTCGCTTTATTCT|TCCAGGGGCACGTTGAGAGCAACATAATCG
TCCATCGTACGGTCTGACTTCTTTCCAGGG|TACCTGAGTCAAATCAGTTGTCCTGCTCTT
GACTTCTTTCCAGGGGTGCCGTATTTTGGG|CTCCATCGTACGGTCTGACTTCTTTCCAGG
GTACGGTCTGACTTCTTTCCAGGGCTTCCA|TTTATCACGTAAAACCCCGGCGTGCGATAG
GCCCGAGCAAATGGCACATGACGACGGTCC|ATTTTGGGAAGACCTACAAGTCGCTTTATT
CCCGTAACGGCAGACGTACAACGAATCATA|CTGCCCGTCGCTTATTGTTAGCCCTACGGT
GGCGGGTCCCGTAACGGCAGACGTACAACG|ATACGGCCTGCCCGTCGCTTATTGTTAGCC
ATGGTGAATGCTACATTCCTTTACCTGAGT|TTTCCAGGGGGTCCACGGGCGTGCTGTTTG
GGGGGTACGCTTCTGCAACTTCGCCTTATA|CGTACGGTCTGACTTCTTTCCAGGGTCTTA
TCCTTGATTAACAATCCCATGCAAGTAGTG|GCTGAGGGGAATATCCATCGTACGGTCTGA
AGGCCCAATCACTTGGTCGTGCGAGGATGT|CCAGGGCGGGTCCCGTAACGGCAGACGTAC
TACAACGAATCATATAGCGTACTTCCCCTA|GTTAGCCCTACGGTCTGGGCGAAATGGAAT
GCGAAATGGAATCGCAAGAGTCCTTGATTA|TCTTTCCAGGGAGTGCAGAGGCTGAGGGGA
AACTTCGCCTTATAGAAATGGCAGGAAACC|TTTCCAGGGTCTTATAGGAGGATGGTGAAT
AATGGTGGTTCCATCGTACGGTCTGACTTC|TGACTTCTTTCCAGGGCGGAATCCATCGTA
CGTGCGAGGATGTATCAAATGTACATATTC|ACGGCAGACGTACAACGAATCATATAGCGT
TGACTTCTTTCCAGGGTCAAATAAGGGTTC|TATAGAAATGGCAGGAAACCGCAGGAGATC
ATTCCTCCATCGTACGGTCTGACTTCTTTC|CCGCGCCCTAGGCCCAATCACTTGGTCGTG
TCTGACTTCTTTCCAGGGTAGCTCAAGATC|AAACATTGGATTAGCCCGAGCAAATGGCAC
CATATGTCCATCGTACGGTCTGACTTCTTT|CATCGTACGGTCTGACTTCTTTCCAGGGCC
CCAGGGCTTCCATCGTACGGTCTGACTTCT|GGCGTGCGATAGCTCGGGTCTGTAATTCCT
CTATGGCGTAGGCCTTACGCATGCAAGTAA|CGCAAGAGTCCTTGATTAACAATCCCATGC
ATAGCGTACTTCCCCTACTATGGCGTAGGC|TCTGGGCGAAATGGAATCGCAAGAGTCCTT
GACTTCTTTCCAGGGCGGAATCCATCGTAC|AGTTGTCCTGCTCTTGGGGACGCCATTTTA
CTGTTTGGGAAACAATCCACTGATCCTACA|CATATTCCTCCAATAGAGGACACATTTCCC
AATCCCATGCAAGTAGTGCTCCGACAAACA|ATCCATCGTACGGTCTGACTTCTTTCCAGG
TGTCATAATTGTAGTGTTCCACCCCGAAGC|TCCAGGGAGTACGCTCCGGCCCAGAGCTAT
GTCTGACTTCTTTCCAGGGGTGCCGTATTT|GCAACTCCATCGTACGGTCTGACTTCTTTC
CCATCGTACGGTCTGACTTCTTTCCAGGGG|CCTAGGCCCAATCACTTGGTCGTGCGAGGA
ACTTGGTCGTGCGAGGATGTATCAAATGTA|TCCCGTAACGGCAGACGTACAACGAATCAT
AGGGCGGGTCCCGTAACGGCAGACGTACAA|ACATACGGCCTGCCCGTCGCTTATTGTTAG
TCTTTCCAGGGCCAATCCCTACGCTGTCAT|GTCCATCGTACGGTCTGACTTCTTTCCAGG
GCCCGTCTCCATTCGGATCCCATTATCGGA|GGTTGGCAGGTTGCTCCCCCCGGGGGTACG
TCCAGGGGGTCCACGGGCGTGCTGTTTGGG|TGCGAGGATGTATCAAATGTACATATTCCT
TCGTACGGTCTGACTTCTTTCCAGGGGTGC|CCCCGAAGCAACTCCATCGTACGGTCTGAC
CGGTCTGACTTCTTTCCAGGGTCTTATAGG|GTCTGTAATTCCTCCATCGTACGGTCTGAC
TTCCTCCATCGTACGGTCTGACTTCTTTCC|CGCGCCCTAGGCCCAATCACTTGGTCGTGC
AACGGCAGACGTACAACGAATCATATAGCG|CGTCGCTTATTGTTAGCCCTACGGTCTGGG
GCAAGAGTCCTTGATTAACAATCCCATGCA|TGCAGAGGCTGAGGGGAATATCCATCGTAC
GGAATCCATCGTACGGTCTGACTTCTTTCC|GGGACGCCATTTTATCACGTAAAACCCCGG
AGGCTGAGGGGAATATCCATCGTACGGTCT|TCATAATTGTAGTGTTCCACCCCGAAGCAA
GTACAACGAATCATATAGCGTACTTCCCCT|TGTTAGCCCTACGGTCTGGGCGAAATGGAA
TTCCAGGGCATGTACAGGCTGAATTTTAAC|GTAATGGTGGTTCCATCGTACGGTCTGACT
ATCAAATGTACATATTCCTCCAATAGAGGA|AACGAATCATATAGCGTACTTCCCCTACTA
GGGACGCCATTTTATCACGTAAAACCCCGG|AGCTCTGTTCGGTTCGTCGCGAACGGATCA
GGGTTTGGACCGTCCATCGTACGGTCTGAC|CCAGGGTCAAATAAGGGTTCCCAGACTTTG
ATCCATCGTACGGTCTGACTTCTTTCCAGG|AGGGTCCATCGTACGGTCTGACTTCTTTCC
CGTCCATCGTACGGTCTGACTTCTTTCCAG|ATAAGGGTTCCCAGACTTTGCGAGGTAATG
TATAGCGTACTTCCCCTACTATGGCGTAGG|GTCTGGGCGAAATGGAATCGCAAGAGTCCT
TACGGTCTGACTTCTTTCCAGGGGGTCCAC|CCCAATCACTTGGTCGTGCGAGGATGTATC
TTCTGCAACTTCGCCTTATAGAAATGGCAG|GACTTCTTTCCAGGGTCTTATAGGAGGATG
TCGGATCCCATTATCGGAGGGTCCATCGTA|GCTCCCCCCGGGGGTACGCTTCTGCAACTT
AGGGTTGGCAGGTTGCTCCCCCCGGGGGTA|TGACTTCTTTCCAGGGCTTCCATCGTACGG
ACTGATCCTACAGCTCTGTTCGGTTCGTCG|GACACATTTCCCTATAAGCTTCCCATACCA
CTTCTTTCCAGGGCATGTACAGGCTGAATT|GCGAGGTAATGGTGGTTCCATCGTACGGTC
TCACATACGGCCTGCCCGTCGCTTATTGTT|ACATGACGACGGTCCACAGGCATATGTCCA
TTCCATCGTACGGTCTGACTTCTTTCCAGG|TTACCTGAGTCAAATCAGTTGTCCTGCTCT
TCCATCGTACGGTCTGACTTCTTTCCAGGG|ATAGCTCGGGTCTGTAATTCCTCCATCGTA
TATCCATCGTACGGTCTGACTTCTTTCCAG|GTTCCACCCCGAAGCAACTCCATCGTACGG
TTCTTTCCAGGGTTGGCAGGTTGCTCCCCC|GTACGGTCTGACTTCTTTCCAGGGCTTCCA
AATGGAATCGCAAGAGTCCTTGATTAACAA|TCCAGGGAGTGCAGAGGCTGAGGGGAATAT
CATTCCTTTACCTGAGTCAAATCAGTTGTC|CACGGGCGTGCTGTTTGGGAAACAATCCAC
ACGGGCGTGCTGTTTGGGAAACAATCCACT|TCAAATGTACATATTCCTCCAATAGAGGAC
ATTATCGGAGGGTCCATCGTACGGTCTGAC|GGGGGTACGCTTCTGCAACTTCGCCTTATA
ATGGCAGGAAACCGCAGGAGATCCTTCCAT|GAGGATGGTGAATGCTACATTCCTTTACCT
GCTGTCATAATTGTAGTGTTCCACCCCGAA|TTTCCAGGGAGTACGCTCCGGCCCAGAGCT
TCGTACGGTCTGACTTCTTTCCAGGGCGGG|CTTTCCAGGGTAGCTCAAGATCACATACGG
CGGTCTGACTTCTTTCCAGGGTCAAATAAG|CGCCTTATAGAAATGGCAGGAAACCGCAGG
TACGCTGTCATAATTGTAGTGTTCCACCCC|TTCTTTCCAGGGAGTACGCTCCGGCCCAGA
TAAGGGTTCCCAGACTTTGCGAGGTAATGG|CAGGAGATCCTTCCATCGTACGGTCTGACT
AAATGTACATATTCCTCCAATAGAGGACAC|GAATCATATAGCGTACTTCCCCTACTATGG
GCGATAGCTCGGGTCTGTAATTCCTCCATC|GCCTCATCGAAGCAAGGGCCCGCGCCCTAG
ACCTACAAGTCGCTTTATTCTATCCATCGT|ACGTTGAGAGCAACATAATCGAAGATGGCT
CCAGGGTCTTATAGGAGGATGGTGAATGCT|ATCGTACGGTCTGACTTCTTTCCAGGGGGT
TTCCTCCAATAGAGGACACATTTCCCTATA|CGTACTTCCCCTACTATGGCGTAGGCCTTA
GATCCTTCCATCGTACGGTCTGACTTCTTT|TTCCTTTACCTGAGTCAAATCAGTTGTCCT
GTCTGACTTCTTTCCAGGGCCAATCCCTAC|CATAGGATGTCCATCGTACGGTCTGACTTC
GAAACCGCAGGAGATCCTTCCATCGTACGG|GTGAATGCTACATTCCTTTACCTGAGTCAA
AAATCAGTTGTCCTGCTCTTGGGGACGCCA|GAAACAATCCACTGATCCTACAGCTCTGTT
CTACTATGGCGTAGGCCTTACGCATGCAAG|AATCGCAAGAGTCCTTGATTAACAATCCCA
TCCAGGGCATGTACAGGCTGAATTTTAACA|TAATGGTGGTTCCATCGTACGGTCTGACTT
ATGCAAGTAAACGTCCATCGTACGGTCTGA|AATCCCATGCAAGTAGTGCTCCGACAAACA
TACTTCAAGTTCTAATCCATCGTACGGTCT|CCATCGTACGGTCTGACTTCTTTCCAGGGT
CCAGGGCCAATCCCTACGCTGTCATAATTG|TCGTACGGTCTGACTTCTTTCCAGGGAGTA
CCTCCAATAGAGGACACATTTCCCTATAAG|TACTTCCCCTACTATGGCGTAGGCCTTACG
TAGCTCGGGTCTGTAATTCCTCCATCGTAC|CATCGAAGCAAGGGCCCGCGCCCTAGGCCC
ACTATGGCGTAGGCCTTACGCATGCAAGTA|TCGCAAGAGTCCTTGATTAACAATCCCATG
TTCTTTCCAGGGGTGCCGTATTTTGGGAAG|CATCGTACGGTCTGACTTCTTTCCAGGGGC
TACAAGTCGCTTTATTCTATCCATCGTACG|TTGAGAGCAACATAATCGAAGATGGCTTTC
GAGGTAATGGTGGTTCCATCGTACGGTCTG|CGGTCTGACTTCTTTCCAGGGCGGAATCCA
ATCCACTGATCCTACAGCTCTGTTCGGTTC|AGAGGACACATTTCCCTATAAGCTTCCCAT
GCGTGCGATAGCTCGGGTCTGTAATTCCTC|ACCCGCCTCATCGAAGCAAGGGCCCGCGCC
AGTGCAGAGGCTGAGGGGAATATCCATCGT|TACGCTGTCATAATTGTAGTGTTCCACCCC
GTCGCTTATTGTTAGCCCTACGGTCTGGGC|AGGCATATGTCCATCGTACGGTCTGACTTC
TCATGATCCATCGTACGGTCTGACTTCTTT|ATCGGAGGGTCCATCGTACGGTCTGACTTC
CACCCCGAAGCAACTCCATCGTACGGTCTG|CCCAGAGCTATATGCTGAGATTGAATCCAC
TCCCCTACTATGGCGTAGGCCTTACGCATG|ATGGAATCGCAAGAGTCCTTGATTAACAAT
CTGCAACTTCGCCTTATAGAAATGGCAGGA|CTTCTTTCCAGGGTCTTATAGGAGGATGGT
TACATATTCCTCCAATAGAGGACACATTTC|ATATAGCGTACTTCCCCTACTATGGCGTAG
GTACGGTCTGACTTCTTTCCAGGGTCTTAT|CGGGTCTGTAATTCCTCCATCGTACGGTCT
AACAATCCCATGCAAGTAGTGCTCCGACAA|AATATCCATCGTACGGTCTGACTTCTTTCC
GGTACGCTTCTGCAACTTCGCCTTATAGAA|ACGGTCTGACTTCTTTCCAGGGTCTTATAG
CCAATCCCTACGCTGTCATAATTGTAGTGT|GGTCTGACTTCTTTCCAGGGAGTACGCTCC
GCTTCCCATACCATGCTACTTCAAGTTCTA|GCATGCAAGTAAACGTCCATCGTACGGTCT
TCGTACGGTCTGACTTCTTTCCAGGGAGTG|TCTGACTTCTTTCCAGGGCCAATCCCTACG
TTCTAATCCATCGTACGGTCTGACTTCTTT|GGTCTGACTTCTTTCCAGGGTAGCTCAAGA
TACGGTCTGACTTCTTTCCAGGGCGGAATC|GTCAAATCAGTTGTCCTGCTCTTGGGGACG
TACGGTCTGACTTCTTTCCAGGGTCAAATA|TTCGCCTTATAGAAATGGCAGGAAACCGCA
TTTCCAGGGCGGAATCCATCGTACGGTCTG|CCTGCTCTTGGGGACGCCATTTTATCACGT
CTCCAATAGAGGACACATTTCCCTATAAGC|ACTTCCCCTACTATGGCGTAGGCCTTACGC
TCCATCGTACGGTCTGACTTCTTTCCAGGG|CTGCAACTTCGCCTTATAGAAATGGCAGGA
TACGGTCTGACTTCTTTCCAGGGCATGTAC|CCCAGACTTTGCGAGGTAATGGTGGTTCCA
TGACTTCTTTCCAGGGGTGCCGTATTTTGG|ACTCCATCGTACGGTCTGACTTCTTTCCAG
GTACGGTCTGACTTCTTTCCAGGGTTGGCA|GCGGAATCCATCGTACGGTCTGACTTCTTT
AATTGTAGTGTTCCACCCCGAAGCAACTCC|GAGTACGCTCCGGCCCAGAGCTATATGCTG
TCTGACTTCTTTCCAGGGCCAATCCCTACG|ATAGGATGTCCATCGTACGGTCTGACTTCT
ACTCCATCGTACGGTCTGACTTCTTTCCAG|TGCTGAGATTGAATCCACACGTGTGTTGCC
AATAGAGGACACATTTCCCTATAAGCTTCC|CCCCTACTATGGCGTAGGCCTTACGCATGC
CATCGTACGGTCTGACTTCTTTCCAGGGCA|GGGTTCCCAGACTTTGCGAGGTAATGGTGG
TTTCCAGGGTCTTATAGGAGGATGGTGAAT|TCCATCGTACGGTCTGACTTCTTTCCAGGG
CAAGTAGTGCTCCGACAAACATTGGATTAG|ACGGTCTGACTTCTTTCCAGGGGTGCCGTA
TTCCATCGTACGGTCTGACTTCTTTCCAGG|GATAGCTCGGGTCTGTAATTCCTCCATCGT
CTTGGTCGTGCGAGGATGTATCAAATGTAC|CCCGTAACGGCAGACGTACAACGAATCATA
CATGATCCATCGTACGGTCTGACTTCTTTC|TCGGAGGGTCCATCGTACGGTCTGACTTCT
TCTATCCATCGTACGGTCTGACTTCTTTCC|TCGAAGATGGCTTTCCATAGGATGTCCATC
GTCCATCGTACGGTCTGACTTCTTTCCAGG|TCTGCAACTTCGCCTTATAGAAATGGCAGG
AGGCTGAATTTTAACATCGCCCCAGCCCGT|TCGTACGGTCTGACTTCTTTCCAGGGTTGG
TTTCCAGGGCTTCCATCGTACGGTCTGACT|CCCGGCGTGCGATAGCTCGGGTCTGTAATT
AGGGTTTGGACCGTCCATCGTACGGTCTGA|TCCAGGGTCAAATAAGGGTTCCCAGACTTT
TGACTTCTTTCCAGGGTTGGCAGGTTGCTC|CATCGTACGGTCTGACTTCTTTCCAGGGCT
GGTCTGACTTCTTTCCAGGGTCTTATAGGA|TCTGTAATTCCTCCATCGTACGGTCTGACT
CTTTCCAGGGCGGGTCCCGTAACGGCAGAC|AAGATCACATACGGCCTGCCCGTCGCTTAT
CTTGGGGACGCCATTTTATCACGTAAAACC|CTACAGCTCTGTTCGGTTCGTCGCGAACGG
AGGGGGTCCACGGGCGTGCTGTTTGGGAAA|GAGGATGTATCAAATGTACATATTCCTCCA
TTCTTTCCAGGGCTTCCATCGTACGGTCTG|AACCCCGGCGTGCGATAGCTCGGGTCTGTA
GTCAAATCAGTTGTCCTGCTCTTGGGGACG|TGGGAAACAATCCACTGATCCTACAGCTCT
TTCCAGGGGGTCCACGGGCGTGCTGTTTGG|GTGCGAGGATGTATCAAATGTACATATTCC
GTGGTTCCATCGTACGGTCTGACTTCTTTC|TTCTTTCCAGGGCGGAATCCATCGTACGGT
AGACGTACAACGAATCATATAGCGTACTTC|TTATTGTTAGCCCTACGGTCTGGGCGAAAT
TCGTACGGTCTGACTTCTTTCCAGGGTAGC|GCTCCGACAAACATTGGATTAGCCCGAGCA
ACAATCCCATGCAAGTAGTGCTCCGACAAA|ATATCCATCGTACGGTCTGACTTCTTTCCA
TGCAAGTAAACGTCCATCGTACGGTCTGAC|ATCCCATGCAAGTAGTGCTCCGACAAACAT
TCTTTCCAGGGCTTCCATCGTACGGTCTGA|ACCCCGGCGTGCGATAGCTCGGGTCTGTAA
TACGGTCTGACTTCTTTCCAGGGTCTTATA|GGGTCTGTAATTCCTCCATCGTACGGTCTG
CGCCATTTTATCACGTAAAACCCCGGCGTG|CTGTTCGGTTCGTCGCGAACGGATCACCCG
AAACAATCCACTGATCCTACAGCTCTGTTC|CCAATAGAGGACACATTTCCCTATAAGCTT
CATTTCCCTATAAGCTTCCCATACCATGCT|GCGTAGGCCTTACGCATGCAAGTAAACGTC
CGGTTCGTCGCGAACGGATCACCCGCCTCA|TCCCATACCATGCTACTTCAAGTTCTAATC
TGTAGTGTTCCACCCCGAAGCAACTCCATC|TACGCTCCGGCCCAGAGCTATATGCTGAGA
GGTTCCCAGACTTTGCGAGGTAATGGTGGT|AGATCCTTCCATCGTACGGTCTGACTTCTT
ATATAGCGTACTTCCCCTACTATGGCGTAG|GGTCTGGGCGAAATGGAATCGCAAGAGTCC
TTCCACCCCGAAGCAACTCCATCGTACGGT|CGGCCCAGAGCTATATGCTGAGATTGAATC
TTCTTTCCAGGGTAGCTCAAGATCACATAC|TGGATTAGCCCGAGCAAATGGCACATGACG
GCTACTTCAAGTTCTAATCCATCGTACGGT|GTCCATCGTACGGTCTGACTTCTTTCCAGG
TCCAGGGTTTGGACCGTCCATCGTACGGTC|CTTTCCAGGGTCAAATAAGGGTTCCCAGAC
CCCCCCGGGGGTACGCTTCTGCAACTTCGC|TTCCATCGTACGGTCTGACTTCTTTCCAGG
GGACACATTTCCCTATAAGCTTCCCATACC|CTATGGCGTAGGCCTTACGCATGCAAGTAA
CAGAGGCTGAGGGGAATATCCATCGTACGG|CTGTCATAATTGTAGTGTTCCACCCCGAAG
ATCCATCGTACGGTCTGACTTCTTTCCAGG|TTCCACCCCGAAGCAACTCCATCGTACGGT
ATTGGATTAGCCCGAGCAAATGGCACATGA|GGGTGCCGTATTTTGGGAAGACCTACAAGT
AGGGCCCGCGCCCTAGGCCCAATCACTTGG|GGTCTGACTTCTTTCCAGGGCGGGTCCCGT
GACCTACAAGTCGCTTTATTCTATCCATCG|CACGTTGAGAGCAACATAATCGAAGATGGC
TGACTTCTTTCCAGGGTTTGGACCGTCCAT|GTCTGACTTCTTTCCAGGGTCAAATAAGGG
ATAGCTCGGGTCTGTAATTCCTCCATCGTA|TCATCGAAGCAAGGGCCCGCGCCCTAGGCC
TACAGCTCTGTTCGGTTCGTCGCGAACGGA|TCCCTATAAGCTTCCCATACCATGCTACTT
AGGGCTTCCATCGTACGGTCTGACTTCTTT|CGTGCGATAGCTCGGGTCTGTAATTCCTCC
CATCGTACGGTCTGACTTCTTTCCAGGGCT|CCATTTTATCACGTAAAACCCCGGCGTGCG
CCATCGTACGGTCTGACTTCTTTCCAGGGT|AGTGCTCCGACAAACATTGGATTAGCCCGA
CTTATTGTTAGCCCTACGGTCTGGGCGAAA|ATATGTCCATCGTACGGTCTGACTTCTTTC
ACGCATGCAAGTAAACGTCCATCGTACGGT|TAACAATCCCATGCAAGTAGTGCTCCGACA
ATGGAATCGCAAGAGTCCTTGATTAACAAT|CCAGGGAGTGCAGAGGCTGAGGGGAATATC
GGTCTGACTTCTTTCCAGGGGGTCCACGGG|AATCACTTGGTCGTGCGAGGATGTATCAAA
AATCCATCGTACGGTCTGACTTCTTTCCAG|TGACTTCTTTCCAGGGTAGCTCAAGATCAC
GATTAGCCCGAGCAAATGGCACATGACGAC|GCCGTATTTTGGGAAGACCTACAAGTCGCT
GTCCATCGTACGGTCTGACTTCTTTCCAGG|TACGGTCTGACTTCTTTCCAGGGCCAATCC
CAGGGCTTCCATCGTACGGTCTGACTTCTT|GCGTGCGATAGCTCGGGTCTGTAATTCCTC
CGCATGCAAGTAAACGTCCATCGTACGGTC|AACAATCCCATGCAAGTAGTGCTCCGACAA
AAATAAGGGTTCCCAGACTTTGCGAGGTAA|CCGCAGGAGATCCTTCCATCGTACGGTCTG
CCATCGTACGGTCTGACTTCTTTCCAGGGC|ACCTGAGTCAAATCAGTTGTCCTGCTCTTG
ATTTTAACATCGCCCCAGCCCGTCTCCATT|GTCTGACTTCTTTCCAGGGTTGGCAGGTTG
AAGGGTTCCCAGACTTTGCGAGGTAATGGT|AGGAGATCCTTCCATCGTACGGTCTGACTT
TCTTTCCAGGGGGTCCACGGGCGTGCTGTT|GTCGTGCGAGGATGTATCAAATGTACATAT
TCTGTTCGGTTCGTCGCGAACGGATCACCC|TAAGCTTCCCATACCATGCTACTTCAAGTT
TCCACTGATCCTACAGCTCTGTTCGGTTCG|GAGGACACATTTCCCTATAAGCTTCCCATA
ACATTCCTTTACCTGAGTCAAATCAGTTGT|CCACGGGCGTGCTGTTTGGGAAACAATCCA
CGGATCACCCGCCTCATCGAAGCAAGGGCC|ACTTCAAGTTCTAATCCATCGTACGGTCTG
TAACGGCAGACGTACAACGAATCATATAGC|CCGTCGCTTATTGTTAGCCCTACGGTCTGG
TTACCTGAGTCAAATCAGTTGTCCTGCTCT|GTGCTGTTTGGGAAACAATCCACTGATCCT
CCGTCTCCATTCGGATCCCATTATCGGAGG|TTGGCAGGTTGCTCCCCCCGGGGGTACGCT
GCTGAATTTTAACATCGCCCCAGCCCGTCT|GTACGGTCTGACTTCTTTCCAGGGTTGGCA
TCTTTCCAGGGTAGCTCAAGATCACATACG|GGATTAGCCCGAGCAAATGGCACATGACGA
TCACGTAAAACCCCGGCGTGCGATAGCTCG|CGTCGCGAACGGATCACCCGCCTCATCGAA
AGGCCTTACGCATGCAAGTAAACGTCCATC|CCTTGATTAACAATCCCATGCAAGTAGTGC
TCTGACTTCTTTCCAGGGAGTGCAGAGGCT|CTTTCCAGGGCCAATCCCTACGCTGTCATA
TAAAACCCCGGCGTGCGATAGCTCGGGTCT|CGAACGGATCACCCGCCTCATCGAAGCAAG
CGGGGGTACGCTTCTGCAACTTCGCCTTAT|TCGTACGGTCTGACTTCTTTCCAGGGTCTT
TTGTAGTGTTCCACCCCGAAGCAACTCCAT|GTACGCTCCGGCCCAGAGCTATATGCTGAG
GGTTTGGACCGTCCATCGTACGGTCTGACT|CAGGGTCAAATAAGGGTTCCCAGACTTTGC
GAATCCATCGTACGGTCTGACTTCTTTCCA|GGACGCCATTTTATCACGTAAAACCCCGGC
AGGATGTATCAAATGTACATATTCCTCCAA|GACGTACAACGAATCATATAGCGTACTTCC
CGAATCATATAGCGTACTTCCCCTACTATG|CCCTACGGTCTGGGCGAAATGGAATCGCAA
CTGTCATAATTGTAGTGTTCCACCCCGAAG|TTCCAGGGAGTACGCTCCGGCCCAGAGCTA
TGATCCTACAGCTCTGTTCGGTTCGTCGCG|CACATTTCCCTATAAGCTTCCCATACCATG
GCAGAGGCTGAGGGGAATATCCATCGTACG|GCTGTCATAATTGTAGTGTTCCACCCCGAA
CCAGGGTTGGCAGGTTGCTCCCCCCGGGGG|TCTGACTTCTTTCCAGGGCTTCCATCGTAC
GTCAAATAAGGGTTCCCAGACTTTGCGAGG|AAACCGCAGGAGATCCTTCCATCGTACGGT
AAATGGAATCGCAAGAGTCCTTGATTAACA|TTCCAGGGAGTGCAGAGGCTGAGGGGAATA
CGCTGTCATAATTGTAGTGTTCCACCCCGA|CTTTCCAGGGAGTACGCTCCGGCCCAGAGC
AGCTCGGGTCTGTAATTCCTCCATCGTACG|ATCGAAGCAAGGGCCCGCGCCCTAGGCCCA
GTGCTGTTTGGGAAACAATCCACTGATCCT|GTACATATTCCTCCAATAGAGGACACATTT
GGAATATCCATCGTACGGTCTGACTTCTTT|TAGTGTTCCACCCCGAAGCAACTCCATCGT
CCTCCATCGTACGGTCTGACTTCTTTCCAG|CGCCCTAGGCCCAATCACTTGGTCGTGCGA
TTTCCAGGGGTGCCGTATTTTGGGAAGACC|CGTACGGTCTGACTTCTTTCCAGGGGCACG
GGGTCCACGGGCGTGCTGTTTGGGAAACAA|GATGTATCAAATGTACATATTCCTCCAATA
AGGGTCCATCGTACGGTCTGACTTCTTTCC|GCTTCTGCAACTTCGCCTTATAGAAATGGC
CCAGGGCATGTACAGGCTGAATTTTAACAT|AATGGTGGTTCCATCGTACGGTCTGACTTC
GCTTCCATCGTACGGTCTGACTTCTTTCCA|GCGATAGCTCGGGTCTGTAATTCCTCCATC
TCGGAGGGTCCATCGTACGGTCTGACTTCT|GTACGCTTCTGCAACTTCGCCTTATAGAAA
ACTTCTTTCCAGGGTTTGGACCGTCCATCG|CTGACTTCTTTCCAGGGTCAAATAAGGGTT
TCTGACTTCTTTCCAGGGGGTCCACGGGCG|TCACTTGGTCGTGCGAGGATGTATCAAATG
ATCACGTAAAACCCCGGCGTGCGATAGCTC|TCGTCGCGAACGGATCACCCGCCTCATCGA
TTGGCAGGTTGCTCCCCCCGGGGGTACGCT|TTCTTTCCAGGGCTTCCATCGTACGGTCTG
AATTCCTCCATCGTACGGTCTGACTTCTTT|CCCGCGCCCTAGGCCCAATCACTTGGTCGT
CCTACGCTGTCATAATTGTAGTGTTCCACC|ACTTCTTTCCAGGGAGTACGCTCCGGCCCA
GTCTGACTTCTTTCCAGGGCGGGTCCCGTA|GGGTAGCTCAAGATCACATACGGCCTGCCC
CCCGGCGTGCGATAGCTCGGGTCTGTAATT|GATCACCCGCCTCATCGAAGCAAGGGCCCG
CCGCGCCCTAGGCCCAATCACTTGGTCGTG|GACTTCTTTCCAGGGCGGGTCCCGTAACGG
TCGTACGGTCTGACTTCTTTCCAGGGCATG|GTTCCCAGACTTTGCGAGGTAATGGTGGTT
CGGTCTGACTTCTTTCCAGGGTAGCTCAAG|GACAAACATTGGATTAGCCCGAGCAAATGG
CGCTTATTGTTAGCCCTACGGTCTGGGCGA|GCATATGTCCATCGTACGGTCTGACTTCTT
CGTGATCATGATCCATCGTACGGTCTGACT|CCATTATCGGAGGGTCCATCGTACGGTCTG
CATGCAAGTAGTGCTCCGACAAACATTGGA|TCGTACGGTCTGACTTCTTTCCAGGGGTGC
GGCCAATCCCTACGCTGTCATAATTGTAGT|ACGGTCTGACTTCTTTCCAGGGAGTACGCT
TCGTACGGTCTGACTTCTTTCCAGGGGGTC|AGGCCCAATCACTTGGTCGTGCGAGGATGT
GATCCCATTATCGGAGGGTCCATCGTACGG|CCCCCCGGGGGTACGCTTCTGCAACTTCGC
TCCCATACCATGCTACTTCAAGTTCTAATC|TGCAAGTAAACGTCCATCGTACGGTCTGAC
GTGCAGAGGCTGAGGGGAATATCCATCGTA|ACGCTGTCATAATTGTAGTGTTCCACCCCG
TCGTACGGTCTGACTTCTTTCCAGGGCTTC|ATTTTATCACGTAAAACCCCGGCGTGCGAT
CTTCCATCGTACGGTCTGACTTCTTTCCAG|TTTACCTGAGTCAAATCAGTTGTCCTGCTC
GAAACAATCCACTGATCCTACAGCTCTGTT|TCCAATAGAGGACACATTTCCCTATAAGCT
ATCCATCGTACGGTCTGACTTCTTTCCAGG|GACTTCTTTCCAGGGTAGCTCAAGATCACA
ACGTCCATCGTACGGTCTGACTTCTTTCCA|AAGTAGTGCTCCGACAAACATTGGATTAGC
ATTGTAGTGTTCCACCCCGAAGCAACTCCA|AGTACGCTCCGGCCCAGAGCTATATGCTGA
ACTTCTTTCCAGGGGTGCCGTATTTTGGGA|TCCATCGTACGGTCTGACTTCTTTCCAGGG
CGTACGGTCTGACTTCTTTCCAGGGTTGGC|GGCGGAATCCATCGTACGGTCTGACTTCTT
CTAGGCCCAATCACTTGGTCGTGCGAGGAT|TTCCAGGGCGGGTCCCGTAACGGCAGACGT
CTTTATTCTATCCATCGTACGGTCTGACTT|ACATAATCGAAGATGGCTTTCCATAGGATG
TTCCAGGGTCTTATAGGAGGATGGTGAATG|CCATCGTACGGTCTGACTTCTTTCCAGGGG
TGTTCCACCCCGAAGCAACTCCATCGTACG|TCCGGCCCAGAGCTATATGCTGAGATTGAA
GGTCTGGGCGAAATGGAATCGCAAGAGTCC|TCTGACTTCTTTCCAGGGAGTGCAGAGGCT
CCATCGTACGGTCTGACTTCTTTCCAGGGT|CCAGGGCGGAATCCATCGTACGGTCTGACT
TTTACCTGAGTCAAATCAGTTGTCCTGCTC|CGTGCTGTTTGGGAAACAATCCACTGATCC
AGGAAACCGCAGGAGATCCTTCCATCGTAC|TGGTGAATGCTACATTCCTTTACCTGAGTC
GCAAGGGCCCGCGCCCTAGGCCCAATCACT|TACGGTCTGACTTCTTTCCAGGGCGGGTCC
AAGGGCCCGCGCCCTAGGCCCAATCACTTG|CGGTCTGACTTCTTTCCAGGGCGGGTCCCG
GCGTACTTCCCCTACTATGGCGTAGGCCTT|GGGCGAAATGGAATCGCAAGAGTCCTTGAT
TCGTACGGTCTGACTTCTTTCCAGGGTCTT|CTCGGGTCTGTAATTCCTCCATCGTACGGT
TCCATCGTACGGTCTGACTTCTTTCCAGGG|ACGGTCTGACTTCTTTCCAGGGCCAATCCC
TTCCAGGGTAGCTCAAGATCACATACGGCC|TTAGCCCGAGCAAATGGCACATGACGACGG
ACGGTCTGACTTCTTTCCAGGGCCAATCCC|TTCCATAGGATGTCCATCGTACGGTCTGAC
ATTGTTAGCCCTACGGTCTGGGCGAAATGG|TGTCCATCGTACGGTCTGACTTCTTTCCAG
AATATCCATCGTACGGTCTGACTTCTTTCC|GTGTTCCACCCCGAAGCAACTCCATCGTAC
AATCACTTGGTCGTGCGAGGATGTATCAAA|CGGGTCCCGTAACGGCAGACGTACAACGAA
ATCGTACGGTCTGACTTCTTTCCAGGGTAG|TGCTCCGACAAACATTGGATTAGCCCGAGC
TGCGATAGCTCGGGTCTGTAATTCCTCCAT|CGCCTCATCGAAGCAAGGGCCCGCGCCCTA
CAGGGTCAAATAAGGGTTCCCAGACTTTGC|CAGGAAACCGCAGGAGATCCTTCCATCGTA
GGTTCCATCGTACGGTCTGACTTCTTTCCA|CTTTCCAGGGCGGAATCCATCGTACGGTCT
TAACAATCCCATGCAAGTAGTGCTCCGACA|GAATATCCATCGTACGGTCTGACTTCTTTC
GCGGAATCCATCGTACGGTCTGACTTCTTT|TGGGGACGCCATTTTATCACGTAAAACCCC
GGGCGTGCTGTTTGGGAAACAATCCACTGA|AAATGTACATATTCCTCCAATAGAGGACAC
CTGTTCGGTTCGTCGCGAACGGATCACCCG|AAGCTTCCCATACCATGCTACTTCAAGTTC
CCCTAGGCCCAATCACTTGGTCGTGCGAGG|CTTTCCAGGGCGGGTCCCGTAACGGCAGAC
AAGTCGCTTTATTCTATCCATCGTACGGTC|AGAGCAACATAATCGAAGATGGCTTTCCAT
GGCGAAATGGAATCGCAAGAGTCCTTGATT|TTCTTTCCAGGGAGTGCAGAGGCTGAGGGG
CAAATAAGGGTTCCCAGACTTTGCGAGGTA|ACCGCAGGAGATCCTTCCATCGTACGGTCT
CGTACGGTCTGACTTCTTTCCAGGGTTTGG|CATCGTACGGTCTGACTTCTTTCCAGGGTC
AGCCCGAGCAAATGGCACATGACGACGGTC|TATTTTGGGAAGACCTACAAGTCGCTTTAT
GTTTGGGAAACAATCCACTGATCCTACAGC|TATTCCTCCAATAGAGGACACATTTCCCTA
GGGTCAAATAAGGGTTCCCAGACTTTGCGA|GGAAACCGCAGGAGATCCTTCCATCGTACG
ATCAGTTGTCCTGCTCTTGGGGACGCCATT|AACAATCCACTGATCCTACAGCTCTGTTCG
GGTCTTATAGGAGGATGGTGAATGCTACAT|TACGGTCTGACTTCTTTCCAGGGGGTCCAC
AGGGAGTGCAGAGGCTGAGGGGAATATCCA|TCCCTACGCTGTCATAATTGTAGTGTTCCA
CAAACATTGGATTAGCCCGAGCAAATGGCA|TCCAGGGGTGCCGTATTTTGGGAAGACCTA
GACTTCTTTCCAGGGCTTCCATCGTACGGT|TAAAACCCCGGCGTGCGATAGCTCGGGTCT
TCAAGATCACATACGGCCTGCCCGTCGCTT|AATGGCACATGACGACGGTCCACAGGCATA
GGGTCCATCGTACGGTCTGACTTCTTTCCA|CTTCTGCAACTTCGCCTTATAGAAATGGCA
CATCGTACGGTCTGACTTCTTTCCAGGGTC|AGCTCGGGTCTGTAATTCCTCCATCGTACG
TATGTCCATCGTACGGTCTGACTTCTTTCC|TCGTACGGTCTGACTTCTTTCCAGGGCCAA
CATCGTACGGTCTGACTTCTTTCCAGGGTC|GCAACTTCGCCTTATAGAAATGGCAGGAAA
AGGGGAATATCCATCGTACGGTCTGACTTC|TTGTAGTGTTCCACCCCGAAGCAACTCCAT
CAATCACTTGGTCGTGCGAGGATGTATCAA|GCGGGTCCCGTAACGGCAGACGTACAACGA
GGGCGGAATCCATCGTACGGTCTGACTTCT|CTTGGGGACGCCATTTTATCACGTAAAACC
TGCCGTATTTTGGGAAGACCTACAAGTCGC|GACTTCTTTCCAGGGGCACGTTGAGAGCAA
GTCTGACTTCTTTCCAGGGGGTCCACGGGC|ATCACTTGGTCGTGCGAGGATGTATCAAAT
GCACATGACGACGGTCCACAGGCATATGTC|CTACAAGTCGCTTTATTCTATCCATCGTAC
TTTCCAGGGCGGGTCCCGTAACGGCAGACG|AGATCACATACGGCCTGCCCGTCGCTTATT
GATGTATCAAATGTACATATTCCTCCAATA|CGTACAACGAATCATATAGCGTACTTCCCC
AGAGTCCTTGATTAACAATCCCATGCAAGT|AGAGGCTGAGGGGAATATCCATCGTACGGT
GTACTTCCCCTACTATGGCGTAGGCCTTAC|GCGAAATGGAATCGCAAGAGTCCTTGATTA
CGGTCTGACTTCTTTCCAGGGCTTCCATCG|ATCACGTAAAACCCCGGCGTGCGATAGCTC
TTCGGTTCGTCGCGAACGGATCACCCGCCT|CTTCCCATACCATGCTACTTCAAGTTCTAA
CGTACGGTCTGACTTCTTTCCAGGGAGTGC|CTGACTTCTTTCCAGGGCCAATCCCTACGC
CGTACGGTCTGACTTCTTTCCAGGGGTGCC|CCCGAAGCAACTCCATCGTACGGTCTGACT
TGAGTCAAATCAGTTGTCCTGCTCTTGGGG|GTTTGGGAAACAATCCACTGATCCTACAGC
CCTACGGTCTGGGCGAAATGGAATCGCAAG|TACGGTCTGACTTCTTTCCAGGGAGTGCAG
TTTCCAGGGTCAAATAAGGGTTCCCAGACT|ATGGCAGGAAACCGCAGGAGATCCTTCCAT
CCCCGGCGTGCGATAGCTCGGGTCTGTAAT|GGATCACCCGCCTCATCGAAGCAAGGGCCC
GTGATCATGATCCATCGTACGGTCTGACTT|CATTATCGGAGGGTCCATCGTACGGTCTGA
CACAGGCATATGTCCATCGTACGGTCTGAC|TCTATCCATCGTACGGTCTGACTTCTTTCC
GTCCATCGTACGGTCTGACTTCTTTCCAGG|TAAGGGTTCCCAGACTTTGCGAGGTAATGG
CGGGCGTGCTGTTTGGGAAACAATCCACTG|CAAATGTACATATTCCTCCAATAGAGGACA
TCAAATGTACATATTCCTCCAATAGAGGAC|ACGAATCATATAGCGTACTTCCCCTACTAT
GGATGGTGAATGCTACATTCCTTTACCTGA|TCTTTCCAGGGGGTCCACGGGCGTGCTGTT
ACTTCGCCTTATAGAAATGGCAGGAAACCG|TTCCAGGGTCTTATAGGAGGATGGTGAATG
CCCTACTATGGCGTAGGCCTTACGCATGCA|GGAATCGCAAGAGTCCTTGATTAACAATCC
CTGACTTCTTTCCAGGGCGGGTCCCGTAAC|GTAGCTCAAGATCACATACGGCCTGCCCGT
GGTTGCTCCCCCCGGGGGTACGCTTCTGCA|CCAGGGCTTCCATCGTACGGTCTGACTTCT
CTTACGCATGCAAGTAAACGTCCATCGTAC|GATTAACAATCCCATGCAAGTAGTGCTCCG
ATAGAGGACACATTTCCCTATAAGCTTCCC|CCCTACTATGGCGTAGGCCTTACGCATGCA
CGTACGGTCTGACTTCTTTCCAGGGCCAAT|GCTTTCCATAGGATGTCCATCGTACGGTCT
ACGGTCTGGGCGAAATGGAATCGCAAGAGT|GGTCTGACTTCTTTCCAGGGAGTGCAGAGG
TAATTGTAGTGTTCCACCCCGAAGCAACTC|GGAGTACGCTCCGGCCCAGAGCTATATGCT
CTTCTTTCCAGGGCGGAATCCATCGTACGG|TTGTCCTGCTCTTGGGGACGCCATTTTATC
CGCCCCAGCCCGTCTCCATTCGGATCCCAT|TTTCCAGGGTTGGCAGGTTGCTCCCCCCGG
TGGGAAGACCTACAAGTCGCTTTATTCTAT|CAGGGGCACGTTGAGAGCAACATAATCGAA
CTCGGGTCTGTAATTCCTCCATCGTACGGT|CGAAGCAAGGGCCCGCGCCCTAGGCCCAAT
AATCGCAAGAGTCCTTGATTAACAATCCCA|GGAGTGCAGAGGCTGAGGGGAATATCCATC
GTCCATCGTACGGTCTGACTTCTTTCCAGG|GTAGTGCTCCGACAAACATTGGATTAGCCC
TTCCATCGTACGGTCTGACTTCTTTCCAGG|TTCCAGGGCGGAATCCATCGTACGGTCTGA
CTAATCCATCGTACGGTCTGACTTCTTTCC|TCTGACTTCTTTCCAGGGTAGCTCAAGATC
CGTACGGTCTGACTTCTTTCCAGGGGGTCC|GGCCCAATCACTTGGTCGTGCGAGGATGTA
ATCACTTGGTCGTGCGAGGATGTATCAAAT|GGGTCCCGTAACGGCAGACGTACAACGAAT
CAGGGCCAATCCCTACGCTGTCATAATTGT|CGTACGGTCTGACTTCTTTCCAGGGAGTAC
CGTCTCCATTCGGATCCCATTATCGGAGGG|TGGCAGGTTGCTCCCCCCGGGGGTACGCTT
GAAGACCTACAAGTCGCTTTATTCTATCCA|GGGCACGTTGAGAGCAACATAATCGAAGAT
ACCCGCCTCATCGAAGCAAGGGCCCGCGCC|AGTTCTAATCCATCGTACGGTCTGACTTCT
TTACGCATGCAAGTAAACGTCCATCGTACG|ATTAACAATCCCATGCAAGTAGTGCTCCGA
CGTGCGATAGCTCGGGTCTGTAATTCCTCC|CCCGCCTCATCGAAGCAAGGGCCCGCGCCC
GCCCGTCGCTTATTGTTAGCCCTACGGTCT|CCACAGGCATATGTCCATCGTACGGTCTGA
CGAAGCAAGGGCCCGCGCCCTAGGCCCAAT|ATCGTACGGTCTGACTTCTTTCCAGGGCGG
TAGCCCGAGCAAATGGCACATGACGACGGT|GTATTTTGGGAAGACCTACAAGTCGCTTTA
TCCATCGTACGGTCTGACTTCTTTCCAGGG|GGGTCCATCGTACGGTCTGACTTCTTTCCA
GTTCCATCGTACGGTCTGACTTCTTTCCAG|TTTCCAGGGCGGAATCCATCGTACGGTCTG
AAACCCCGGCGTGCGATAGCTCGGGTCTGT|AACGGATCACCCGCCTCATCGAAGCAAGGG
TTCCAGGGGTGCCGTATTTTGGGAAGACCT|GTACGGTCTGACTTCTTTCCAGGGGCACGT
TGACTTCTTTCCAGGGCCAATCCCTACGCT|AGGATGTCCATCGTACGGTCTGACTTCTTT
TGCAAGTAGTGCTCCGACAAACATTGGATT|GTACGGTCTGACTTCTTTCCAGGGGTGCCG
TTTCCAGGGTTGGCAGGTTGCTCCCCCCGG|CGGTCTGACTTCTTTCCAGGGCTTCCATCG
CTACAAGTCGCTTTATTCTATCCATCGTAC|GTTGAGAGCAACATAATCGAAGATGGCTTT
CTGACTTCTTTCCAGGGCGGAATCCATCGT|TCAGTTGTCCTGCTCTTGGGGACGCCATTT
GTACATATTCCTCCAATAGAGGACACATTT|CATATAGCGTACTTCCCCTACTATGGCGTA
CATACGGCCTGCCCGTCGCTTATTGTTAGC|TGACGACGGTCCACAGGCATATGTCCATCG
TACTATGGCGTAGGCCTTACGCATGCAAGT|ATCGCAAGAGTCCTTGATTAACAATCCCAT
TCGTACGGTCTGACTTCTTTCCAGGGCGGA|TGAGTCAAATCAGTTGTCCTGCTCTTGGGG
CATGCTACTTCAAGTTCTAATCCATCGTAC|AACGTCCATCGTACGGTCTGACTTCTTTCC
CAATCCCTACGCTGTCATAATTGTAGTGTT|GTCTGACTTCTTTCCAGGGAGTACGCTCCG
ACTTTGCGAGGTAATGGTGGTTCCATCGTA|CATCGTACGGTCTGACTTCTTTCCAGGGCG
ATTCTATCCATCGTACGGTCTGACTTCTTT|AATCGAAGATGGCTTTCCATAGGATGTCCA
GGTTGGCAGGTTGCTCCCCCCGGGGGTACG|ACTTCTTTCCAGGGCTTCCATCGTACGGTC
TGACTTCTTTCCAGGGTAGCTCAAGATCAC|ACATTGGATTAGCCCGAGCAAATGGCACAT
GAGGATGTATCAAATGTACATATTCCTCCA|AGACGTACAACGAATCATATAGCGTACTTC
GGATCACCCGCCTCATCGAAGCAAGGGCCC|CTTCAAGTTCTAATCCATCGTACGGTCTGA
TATCCATCGTACGGTCTGACTTCTTTCCAG|GAAGATGGCTTTCCATAGGATGTCCATCGT
TGGCAGGTTGCTCCCCCCGGGGGTACGCTT|TCTTTCCAGGGCTTCCATCGTACGGTCTGA
TCCTCCAATAGAGGACACATTTCCCTATAA|GTACTTCCCCTACTATGGCGTAGGCCTTAC
TAGTGCTCCGACAAACATTGGATTAGCCCG|TCTGACTTCTTTCCAGGGGTGCCGTATTTT
GGCTGAATTTTAACATCGCCCCAGCCCGTC|CGTACGGTCTGACTTCTTTCCAGGGTTGGC
GGATGTATCAAATGTACATATTCCTCCAAT|ACGTACAACGAATCATATAGCGTACTTCCC
TGCAGAGGCTGAGGGGAATATCCATCGTAC|CGCTGTCATAATTGTAGTGTTCCACCCCGA
GGCTGAGGGGAATATCCATCGTACGGTCTG|CATAATTGTAGTGTTCCACCCCGAAGCAAC
TGGCACATGACGACGGTCCACAGGCATATG|ACCTACAAGTCGCTTTATTCTATCCATCGT
CACATTTCCCTATAAGCTTCCCATACCATG|TGGCGTAGGCCTTACGCATGCAAGTAAACG
TTAGCCCGAGCAAATGGCACATGACGACGG|CGTATTTTGGGAAGACCTACAAGTCGCTTT
TGTTAGCCCTACGGTCTGGGCGAAATGGAA|TCCATCGTACGGTCTGACTTCTTTCCAGGG
CCCTATAAGCTTCCCATACCATGCTACTTC|GGCCTTACGCATGCAAGTAAACGTCCATCG
ATAAGGGTTCCCAGACTTTGCGAGGTAATG|GCAGGAGATCCTTCCATCGTACGGTCTGAC
AAACCGCAGGAGATCCTTCCATCGTACGGT|TGAATGCTACATTCCTTTACCTGAGTCAAA
ATCGTACGGTCTGACTTCTTTCCAGGGAGT|GTCTGACTTCTTTCCAGGGCCAATCCCTAC
GAGGGTCCATCGTACGGTCTGACTTCTTTC|CGCTTCTGCAACTTCGCCTTATAGAAATGG
GGGTCTGTAATTCCTCCATCGTACGGTCTG|AGCAAGGGCCCGCGCCCTAGGCCCAATCAC
TCCTCCATCGTACGGTCTGACTTCTTTCCA|GCGCCCTAGGCCCAATCACTTGGTCGTGCG
TGCTGTTTGGGAAACAATCCACTGATCCTA|TACATATTCCTCCAATAGAGGACACATTTC
ACGGTCTGACTTCTTTCCAGGGAGTGCAGA|ACTTCTTTCCAGGGCCAATCCCTACGCTGT
GGTGGTTCCATCGTACGGTCTGACTTCTTT|CTTCTTTCCAGGGCGGAATCCATCGTACGG
AGGGCATGTACAGGCTGAATTTTAACATCG|TGGTGGTTCCATCGTACGGTCTGACTTCTT
TGGGGACGCCATTTTATCACGTAAAACCCC|ACAGCTCTGTTCGGTTCGTCGCGAACGGAT
CTGACTTCTTTCCAGGGTAGCTCAAGATCA|AACATTGGATTAGCCCGAGCAAATGGCACA
TTTATCACGTAAAACCCCGGCGTGCGATAG|GGTTCGTCGCGAACGGATCACCCGCCTCAT
AGTAGTGCTCCGACAAACATTGGATTAGCC|GGTCTGACTTCTTTCCAGGGGTGCCGTATT
ACTTCTTTCCAGGGCCAATCCCTACGCTGT|GATGTCCATCGTACGGTCTGACTTCTTTCC
AAGACCTACAAGTCGCTTTATTCTATCCAT|GGCACGTTGAGAGCAACATAATCGAAGATG
CAGGCATATGTCCATCGTACGGTCTGACTT|TATCCATCGTACGGTCTGACTTCTTTCCAG
ACGGTCTGACTTCTTTCCAGGGTTTGGACC|CGTACGGTCTGACTTCTTTCCAGGGTCAAA
CTATCCATCGTACGGTCTGACTTCTTTCCA|CGAAGATGGCTTTCCATAGGATGTCCATCG
ACGTACAACGAATCATATAGCGTACTTCCC|ATTGTTAGCCCTACGGTCTGGGCGAAATGG
CTTCTTTCCAGGGGTGCCGTATTTTGGGAA|CCATCGTACGGTCTGACTTCTTTCCAGGGG
AGGAGATCCTTCCATCGTACGGTCTGACTT|TACATTCCTTTACCTGAGTCAAATCAGTTG
GACTTCTTTCCAGGGAGTGCAGAGGCTGAG|TCCAGGGCCAATCCCTACGCTGTCATAATT
GGCTTCCATCGTACGGTCTGACTTCTTTCC|TGCGATAGCTCGGGTCTGTAATTCCTCCAT
CCAGACTTTGCGAGGTAATGGTGGTTCCAT|CTTCCATCGTACGGTCTGACTTCTTTCCAG
ATCGTACGGTCTGACTTCTTTCCAGGGTCA|CAACTTCGCCTTATAGAAATGGCAGGAAAC
CATTTTATCACGTAAAACCCCGGCGTGCGA|TTCGGTTCGTCGCGAACGGATCACCCGCCT
CATTGGATTAGCCCGAGCAAATGGCACATG|GGGGTGCCGTATTTTGGGAAGACCTACAAG
CGGTCTGACTTCTTTCCAGGGCGGGTCCCG|CAGGGTAGCTCAAGATCACATACGGCCTGC
TTCTTTCCAGGGCGGGTCCCGTAACGGCAG|TCAAGATCACATACGGCCTGCCCGTCGCTT
TCGTGATCATGATCCATCGTACGGTCTGAC|CCCATTATCGGAGGGTCCATCGTACGGTCT
TGCTCTTGGGGACGCCATTTTATCACGTAA|GATCCTACAGCTCTGTTCGGTTCGTCGCGA
CTGACTTCTTTCCAGGGGTGCCGTATTTTG|AACTCCATCGTACGGTCTGACTTCTTTCCA
GACGGTCCACAGGCATATGTCCATCGTACG|GCTTTATTCTATCCATCGTACGGTCTGACT
AATTTTAACATCGCCCCAGCCCGTCTCCAT|GGTCTGACTTCTTTCCAGGGTTGGCAGGTT
TCAGTTGTCCTGCTCTTGGGGACGCCATTT|ACAATCCACTGATCCTACAGCTCTGTTCGG
CTCCGACAAACATTGGATTAGCCCGAGCAA|CTTCTTTCCAGGGGTGCCGTATTTTGGGAA
TGCTACTTCAAGTTCTAATCCATCGTACGG|CGTCCATCGTACGGTCTGACTTCTTTCCAG
CAACTCCATCGTACGGTCTGACTTCTTTCC|TATGCTGAGATTGAATCCACACGTGTGTTG
GGGAGTGCAGAGGCTGAGGGGAATATCCAT|CCCTACGCTGTCATAATTGTAGTGTTCCAC
GGAGATCCTTCCATCGTACGGTCTGACTTC|ACATTCCTTTACCTGAGTCAAATCAGTTGT
ACGGTCTGACTTCTTTCCAGGGCATGTACA|CCAGACTTTGCGAGGTAATGGTGGTTCCAT
TACCATGCTACTTCAAGTTCTAATCCATCG|GTAAACGTCCATCGTACGGTCTGACTTCTT
AGTTCTAATCCATCGTACGGTCTGACTTCT|ACGGTCTGACTTCTTTCCAGGGTAGCTCAA
CCATCGTACGGTCTGACTTCTTTCCAGGGG|CCACCCCGAAGCAACTCCATCGTACGGTCT
CTTATAGAAATGGCAGGAAACCGCAGGAGA|GTCTTATAGGAGGATGGTGAATGCTACATT
AGTCAAATCAGTTGTCCTGCTCTTGGGGAC|TTGGGAAACAATCCACTGATCCTACAGCTC
GTACGGTCTGACTTCTTTCCAGGGTTTGGA|ATCGTACGGTCTGACTTCTTTCCAGGGTCA
CAACGAATCATATAGCGTACTTCCCCTACT|TAGCCCTACGGTCTGGGCGAAATGGAATCG
GCAAATGGCACATGACGACGGTCCACAGGC|GGAAGACCTACAAGTCGCTTTATTCTATCC
CTGACTTCTTTCCAGGGCTTCCATCGTACG|CGTAAAACCCCGGCGTGCGATAGCTCGGGT
CGACAAACATTGGATTAGCCCGAGCAAATG|CTTTCCAGGGGTGCCGTATTTTGGGAAGAC
ACAGCTCTGTTCGGTTCGTCGCGAACGGAT|CCCTATAAGCTTCCCATACCATGCTACTTC
CTGACTTCTTTCCAGGGGGTCCACGGGCGT|CACTTGGTCGTGCGAGGATGTATCAAATGT
CGTACGGTCTGACTTCTTTCCAGGGCGGGT|TTTCCAGGGTAGCTCAAGATCACATACGGC
GTACGGTCTGACTTCTTTCCAGGGCGGAAT|AGTCAAATCAGTTGTCCTGCTCTTGGGGAC
ACGACGGTCCACAGGCATATGTCCATCGTA|TCGCTTTATTCTATCCATCGTACGGTCTGA
TTCCCAGACTTTGCGAGGTAATGGTGGTTC|ATCCTTCCATCGTACGGTCTGACTTCTTTC
CTTTCCAGGGCTTCCATCGTACGGTCTGAC|CCCCGGCGTGCGATAGCTCGGGTCTGTAAT
TCTTGGGGACGCCATTTTATCACGTAAAAC|CCTACAGCTCTGTTCGGTTCGTCGCGAACG
TGGTGAATGCTACATTCCTTTACCTGAGTC|TTCCAGGGGGTCCACGGGCGTGCTGTTTGG
GACGTACAACGAATCATATAGCGTACTTCC|TATTGTTAGCCCTACGGTCTGGGCGAAATG
GGGGGTCCACGGGCGTGCTGTTTGGGAAAC|AGGATGTATCAAATGTACATATTCCTCCAA
TTTATTCTATCCATCGTACGGTCTGACTTC|CATAATCGAAGATGGCTTTCCATAGGATGT
CACTGATCCTACAGCTCTGTTCGGTTCGTC|GGACACATTTCCCTATAAGCTTCCCATACC
CTGAGGGGAATATCCATCGTACGGTCTGAC|TAATTGTAGTGTTCCACCCCGAAGCAACTC
CCGCAGGAGATCCTTCCATCGTACGGTCTG|ATGCTACATTCCTTTACCTGAGTCAAATCA
CATATAGCGTACTTCCCCTACTATGGCGTA|CGGTCTGGGCGAAATGGAATCGCAAGAGTC
CCCGCGCCCTAGGCCCAATCACTTGGTCGT|TGACTTCTTTCCAGGGCGGGTCCCGTAACG
ATCGCCCCAGCCCGTCTCCATTCGGATCCC|TCTTTCCAGGGTTGGCAGGTTGCTCCCCCC
GCCATTTTATCACGTAAAACCCCGGCGTGC|TGTTCGGTTCGTCGCGAACGGATCACCCGC
CTTTCCAGGGCGGAATCCATCGTACGGTCT|TCCTGCTCTTGGGGACGCCATTTTATCACG
GTTGGCAGGTTGCTCCCCCCGGGGGTACGC|CTTCTTTCCAGGGCTTCCATCGTACGGTCT
TCCTTCCATCGTACGGTCTGACTTCTTTCC|CCTTTACCTGAGTCAAATCAGTTGTCCTGC
CACGTAAAACCCCGGCGTGCGATAGCTCGG|GTCGCGAACGGATCACCCGCCTCATCGAAG
GGCATATGTCCATCGTACGGTCTGACTTCT|TCCATCGTACGGTCTGACTTCTTTCCAGGG
GGCACATGACGACGGTCCACAGGCATATGT|CCTACAAGTCGCTTTATTCTATCCATCGTA
ACCGCAGGAGATCCTTCCATCGTACGGTCT|AATGCTACATTCCTTTACCTGAGTCAAATC
CTTCAAGTTCTAATCCATCGTACGGTCTGA|ATCGTACGGTCTGACTTCTTTCCAGGGTAG
GTCTTATAGGAGGATGGTGAATGCTACATT|ACGGTCTGACTTCTTTCCAGGGGGTCCACG
TGACTTCTTTCCAGGGTCTTATAGGAGGAT|TAATTCCTCCATCGTACGGTCTGACTTCTT
CCTTCCATCGTACGGTCTGACTTCTTTCCA|CTTTACCTGAGTCAAATCAGTTGTCCTGCT
ACGGATCACCCGCCTCATCGAAGCAAGGGC|TACTTCAAGTTCTAATCCATCGTACGGTCT
AGCGTACTTCCCCTACTATGGCGTAGGCCT|TGGGCGAAATGGAATCGCAAGAGTCCTTGA
TCCTTTACCTGAGTCAAATCAGTTGTCCTG|GGGCGTGCTGTTTGGGAAACAATCCACTGA
TTCCCATACCATGCTACTTCAAGTTCTAAT|ATGCAAGTAAACGTCCATCGTACGGTCTGA
CTTTCCAGGGCATGTACAGGCTGAATTTTA|AGGTAATGGTGGTTCCATCGTACGGTCTGA
ATCGGAGGGTCCATCGTACGGTCTGACTTC|GGTACGCTTCTGCAACTTCGCCTTATAGAA
GACTTCTTTCCAGGGTCTTATAGGAGGATG|AATTCCTCCATCGTACGGTCTGACTTCTTT
AAGCAACTCCATCGTACGGTCTGACTTCTT|CTATATGCTGAGATTGAATCCACACGTGTG
TAATGGTGGTTCCATCGTACGGTCTGACTT|CTGACTTCTTTCCAGGGCGGAATCCATCGT
CGTACAACGAATCATATAGCGTACTTCCCC|TTGTTAGCCCTACGGTCTGGGCGAAATGGA
CGCCCTAGGCCCAATCACTTGGTCGTGCGA|TTCTTTCCAGGGCGGGTCCCGTAACGGCAG
AATGTACATATTCCTCCAATAGAGGACACA|AATCATATAGCGTACTTCCCCTACTATGGC
AGATCCTTCCATCGTACGGTCTGACTTCTT|ATTCCTTTACCTGAGTCAAATCAGTTGTCC
CCCGCCTCATCGAAGCAAGGGCCCGCGCCC|GTTCTAATCCATCGTACGGTCTGACTTCTT
GGGTACGCTTCTGCAACTTCGCCTTATAGA|TACGGTCTGACTTCTTTCCAGGGTCTTATA
TTATTCTATCCATCGTACGGTCTGACTTCT|ATAATCGAAGATGGCTTTCCATAGGATGTC
CGAGCAAATGGCACATGACGACGGTCCACA|TTGGGAAGACCTACAAGTCGCTTTATTCTA
TGTTTGGGAAACAATCCACTGATCCTACAG|ATATTCCTCCAATAGAGGACACATTTCCCT
CCATACCATGCTACTTCAAGTTCTAATCCA|CAAGTAAACGTCCATCGTACGGTCTGACTT
ATGACGACGGTCCACAGGCATATGTCCATC|AAGTCGCTTTATTCTATCCATCGTACGGTC
GATCCATCGTACGGTCTGACTTCTTTCCAG|GAGGGTCCATCGTACGGTCTGACTTCTTTC
TCATCGAAGCAAGGGCCCGCGCCCTAGGCC|ATCCATCGTACGGTCTGACTTCTTTCCAGG
GTTCCACCCCGAAGCAACTCCATCGTACGG|CCGGCCCAGAGCTATATGCTGAGATTGAAT
TGGTTCCATCGTACGGTCTGACTTCTTTCC|TCTTTCCAGGGCGGAATCCATCGTACGGTC
ATAGAAATGGCAGGAAACCGCAGGAGATCC|TTATAGGAGGATGGTGAATGCTACATTCCT
TGTCCATCGTACGGTCTGACTTCTTTCCAG|GTACGGTCTGACTTCTTTCCAGGGCCAATC
ATGTATCAAATGTACATATTCCTCCAATAG|GTACAACGAATCATATAGCGTACTTCCCCT
TATAAGCTTCCCATACCATGCTACTTCAAG|CTTACGCATGCAAGTAAACGTCCATCGTAC
TCAAGTTCTAATCCATCGTACGGTCTGACT|CGTACGGTCTGACTTCTTTCCAGGGTAGCT
GGTCTGACTTCTTTCCAGGGGTGCCGTATT|AGCAACTCCATCGTACGGTCTGACTTCTTT
CAGGAGATCCTTCCATCGTACGGTCTGACT|CTACATTCCTTTACCTGAGTCAAATCAGTT
AATCCATCGTACGGTCTGACTTCTTTCCAG|GACGCCATTTTATCACGTAAAACCCCGGCG
AGCAACTCCATCGTACGGTCTGACTTCTTT|TATATGCTGAGATTGAATCCACACGTGTGT
ACGGTCTGACTTCTTTCCAGGGCGGGTCCC|CCAGGGTAGCTCAAGATCACATACGGCCTG
GTCTGACTTCTTTCCAGGGAGTGCAGAGGC|TCTTTCCAGGGCCAATCCCTACGCTGTCAT
ACATGACGACGGTCCACAGGCATATGTCCA|ACAAGTCGCTTTATTCTATCCATCGTACGG
CTGACTTCTTTCCAGGGCATGTACAGGCTG|CTTTGCGAGGTAATGGTGGTTCCATCGTAC
CTGCCCGTCGCTTATTGTTAGCCCTACGGT|GTCCACAGGCATATGTCCATCGTACGGTCT
CGCCTCATCGAAGCAAGGGCCCGCGCCCTA|TCTAATCCATCGTACGGTCTGACTTCTTTC
CGCGCCCTAGGCCCAATCACTTGGTCGTGC|ACTTCTTTCCAGGGCGGGTCCCGTAACGGC
GTACGGTCTGACTTCTTTCCAGGGTCAAAT|CTTCGCCTTATAGAAATGGCAGGAAACCGC
TACGGTCTGACTTCTTTCCAGGGGTGCCGT|CGAAGCAACTCCATCGTACGGTCTGACTTC
GCTCCGACAAACATTGGATTAGCCCGAGCA|ACTTCTTTCCAGGGGTGCCGTATTTTGGGA
TGCTCCGACAAACATTGGATTAGCCCGAGC|GACTTCTTTCCAGGGGTGCCGTATTTTGGG
ATCGTACGGTCTGACTTCTTTCCAGGGCAT|GGTTCCCAGACTTTGCGAGGTAATGGTGGT
TTCTTTCCAGGGTCTTATAGGAGGATGGTG|TCCTCCATCGTACGGTCTGACTTCTTTCCA
CCGCCTCATCGAAGCAAGGGCCCGCGCCCT|TTCTAATCCATCGTACGGTCTGACTTCTTT
TTCCAGGGTTGGCAGGTTGCTCCCCCCGGG|GGTCTGACTTCTTTCCAGGGCTTCCATCGT
CGGCCTGCCCGTCGCTTATTGTTAGCCCTA|GACGGTCCACAGGCATATGTCCATCGTACG
CTTTCCAGGGTCAAATAAGGGTTCCCAGAC|AATGGCAGGAAACCGCAGGAGATCCTTCCA
ATGATCCATCGTACGGTCTGACTTCTTTCC|CGGAGGGTCCATCGTACGGTCTGACTTCTT
CATACCATGCTACTTCAAGTTCTAATCCAT|AAGTAAACGTCCATCGTACGGTCTGACTTC
ATGTACAGGCTGAATTTTAACATCGCCCCA|GTTCCATCGTACGGTCTGACTTCTTTCCAG
TCCCGTAACGGCAGACGTACAACGAATCAT|CCTGCCCGTCGCTTATTGTTAGCCCTACGG
CCGTATTTTGGGAAGACCTACAAGTCGCTT|CTTCTTTCCAGGGGCACGTTGAGAGCAACA
GGCCCGCGCCCTAGGCCCAATCACTTGGTC|TCTGACTTCTTTCCAGGGCGGGTCCCGTAA
GCATGTACAGGCTGAATTTTAACATCGCCC|TGGTTCCATCGTACGGTCTGACTTCTTTCC
ATGTCCATCGTACGGTCTGACTTCTTTCCA|CGTACGGTCTGACTTCTTTCCAGGGCCAAT
CCACAGGCATATGTCCATCGTACGGTCTGA|TTCTATCCATCGTACGGTCTGACTTCTTTC
ACATACGGCCTGCCCGTCGCTTATTGTTAG|ATGACGACGGTCCACAGGCATATGTCCATC
TTCCCCTACTATGGCGTAGGCCTTACGCAT|AATGGAATCGCAAGAGTCCTTGATTAACAA
CAATAGAGGACACATTTCCCTATAAGCTTC|TCCCCTACTATGGCGTAGGCCTTACGCATG
GATCACCCGCCTCATCGAAGCAAGGGCCCG|TTCAAGTTCTAATCCATCGTACGGTCTGAC
TCGCTTTATTCTATCCATCGTACGGTCTGA|GCAACATAATCGAAGATGGCTTTCCATAGG
TCATATAGCGTACTTCCCCTACTATGGCGT|ACGGTCTGGGCGAAATGGAATCGCAAGAGT
TTATAGGAGGATGGTGAATGCTACATTCCT|GTCTGACTTCTTTCCAGGGGGTCCACGGGC
AACCCCGGCGTGCGATAGCTCGGGTCTGTA|ACGGATCACCCGCCTCATCGAAGCAAGGGC
TCGCAAGAGTCCTTGATTAACAATCCCATG|AGTGCAGAGGCTGAGGGGAATATCCATCGT
GGAGGGTCCATCGTACGGTCTGACTTCTTT|ACGCTTCTGCAACTTCGCCTTATAGAAATG
CCTTACGCATGCAAGTAAACGTCCATCGTA|TGATTAACAATCCCATGCAAGTAGTGCTCC
CTCATCGAAGCAAGGGCCCGCGCCCTAGGC|AATCCATCGTACGGTCTGACTTCTTTCCAG
TTTCCCTATAAGCTTCCCATACCATGCTAC|GTAGGCCTTACGCATGCAAGTAAACGTCCA
AGCTCAAGATCACATACGGCCTGCCCGTCG|GCAAATGGCACATGACGACGGTCCACAGGC
TTCCAGGGAGTGCAGAGGCTGAGGGGAATA|CCAATCCCTACGCTGTCATAATTGTAGTGT
CCCAGACTTTGCGAGGTAATGGTGGTTCCA|CCTTCCATCGTACGGTCTGACTTCTTTCCA
TAAGCTTCCCATACCATGCTACTTCAAGTT|TACGCATGCAAGTAAACGTCCATCGTACGG
